Player,Pos,Age,Tm,G,GS,MP,FG,FGA,3P,3PA,2P,2PA,FT,FTA,ORB,DRB,TRB,AST,STL,BLK,TOV,PF,PTS
A.J. Price,PG,28,TOT,26,0,324,51,137,15,57,36,80,16,24,6,26,32,46,7,0,14,15,133
Aaron Brooks,PG,30,CHI,82,21,1885,344,817,121,313,223,504,145,174,32,134,166,261,54,15,157,189,954
Aaron Gordon,PF,19,ORL,47,8,797,93,208,13,48,80,160,44,61,46,123,169,33,21,22,38,83,243
Adreian Payne,PF,23,TOT,32,22,739,91,220,1,9,90,211,30,46,48,114,162,30,19,9,44,88,213
Al Horford,C,28,ATL,76,76,2318,519,965,11,36,508,929,107,141,131,413,544,244,68,98,100,121,1156
Al Jefferson,C,30,CHO,65,61,1992,486,1010,2,5,484,1005,108,165,99,449,548,113,47,84,68,139,1082
Al-Farouq Aminu,SF,24,DAL,74,3,1366,147,357,34,124,113,233,84,118,114,228,342,59,70,62,55,137,412
Alan Anderson,SG,32,BRK,74,19,1744,195,440,73,210,122,230,82,101,31,173,204,83,56,5,60,148,545
Alec Burks,SG,23,UTA,27,27,899,121,300,26,68,95,232,106,129,19,95,114,82,17,5,52,64,374
Alex Kirk,C,23,CLE,5,0,14,1,4,0,0,1,4,2,2,1,0,1,1,0,0,0,1,4
Alex Len,C,21,PHO,69,44,1518,179,353,1,3,178,350,73,104,142,312,454,32,34,105,74,213,432
Alexey Shved,SG,26,TOT,42,9,767,133,335,47,139,86,196,121,150,23,76,99,106,30,6,48,48,434
Alexis Ajinca,C,26,NOP,68,8,957,181,329,0,0,181,329,81,99,104,211,315,47,21,51,69,151,443
Allen Crabbe,SG,22,POR,51,9,683,63,153,30,85,33,68,12,16,7,66,73,39,19,15,15,74,168
Alonzo Gee,SF,27,TOT,54,2,662,87,186,13,35,74,151,54,77,37,57,94,25,35,7,33,58,241
Amar'e Stoudemire,PF,32,TOT,59,15,1245,273,490,0,4,273,486,134,186,110,219,329,45,29,38,78,161,680
Amir Johnson,PF,27,TOR,75,72,1979,298,519,19,46,279,473,79,129,159,297,456,117,44,59,110,225,694
Anderson Varejao,C,32,CLE,26,26,636,111,200,0,2,111,198,33,45,57,113,170,35,19,16,35,58,255
Andre Dawkins,SG,23,MIA,4,0,22,1,6,1,6,0,0,0,0,0,2,2,1,0,0,1,3,3
Andre Drummond,C,21,DET,82,82,2502,494,961,0,2,494,959,142,365,437,667,1104,55,73,153,120,285,1130
Andre Iguodala,SF,31,GSW,77,0,2069,231,496,74,212,157,284,68,114,44,213,257,228,89,25,88,100,604
Andre Miller,PG,38,TOT,81,0,1253,145,290,7,34,138,256,58,77,37,116,153,284,32,6,104,103,355
Andre Roberson,SG,23,OKC,67,65,1286,92,201,21,85,71,116,23,48,60,195,255,70,53,29,46,141,228
Andrea Bargnani,C,29,NYK,29,22,785,164,361,15,41,149,320,87,107,32,95,127,46,2,27,42,53,430
Andrei Kirilenko,SF,33,BRK,7,0,36,0,5,0,0,0,5,3,4,2,6,8,1,1,0,1,1,3
Andrew Bogut,C,30,GSW,67,65,1583,200,355,0,0,200,355,22,42,141,402,543,180,39,113,106,188,422
Andrew Nicholson,PF,25,ORL,40,3,492,83,190,13,41,70,149,15,25,17,65,82,22,6,12,24,51,194
Andrew Wiggins,SF,19,MIN,82,82,2969,497,1137,39,126,458,1011,354,466,134,240,374,170,86,50,177,190,1387
Anthony Bennett,PF,21,MIN,57,3,894,125,297,7,23,118,274,41,64,52,164,216,48,27,16,36,87,298
Anthony Davis,PF,21,NOP,68,68,2455,642,1199,1,12,641,1187,371,461,173,523,696,149,100,200,95,141,1656
Anthony Morrow,SG,29,OKC,74,0,1806,285,615,141,325,144,290,79,89,40,155,195,60,54,11,38,135,790
Anthony Tolliver,PF,29,TOT,76,11,1432,161,393,106,290,55,103,54,69,51,185,236,59,24,16,51,137,482
Archie Goodwin,SG,20,PHO,41,2,535,79,201,12,41,67,160,61,83,27,47,74,44,18,9,48,55,231
Arinze Onuaku,C,27,MIN,6,1,68,12,14,0,0,12,14,3,8,7,14,21,4,1,3,2,6,27
Aron Baynes,C,28,SAS,70,17,1122,185,327,1,4,184,323,90,104,109,209,318,35,16,22,65,162,461
Arron Afflalo,SG,29,TOT,78,72,2502,375,884,118,333,257,551,167,198,27,220,247,129,41,7,116,167,1035
Austin Daye,SF,26,TOT,34,4,344,50,141,24,71,26,70,5,6,10,65,75,17,12,5,23,39,129
Austin Rivers,PG-SG,22,TOT,76,5,1563,203,496,39,131,164,365,85,126,27,125,152,155,48,14,65,146,530
Avery Bradley,SG,24,BOS,77,77,2428,434,1012,124,352,310,660,79,100,46,195,241,135,82,15,109,177,1071
Ben Gordon,SG,31,ORL,56,0,790,129,295,35,97,94,198,56,67,6,57,63,50,14,1,55,60,349
Ben McLemore,SG,21,SAC,82,82,2670,363,831,140,391,223,440,130,160,31,210,241,140,77,19,138,219,996
Beno Udrih,PG,32,MEM,79,12,1494,246,505,26,97,220,408,87,102,20,123,143,220,46,8,89,88,605
Bernard James,C,29,DAL,16,2,158,12,27,0,0,12,27,20,23,18,21,39,4,2,15,6,17,44
Bismack Biyombo,C,22,CHO,64,21,1243,101,186,0,0,101,186,102,175,159,248,407,16,18,99,52,140,304
Blake Griffin,PF,25,LAC,67,67,2356,574,1144,10,25,564,1119,311,427,126,382,508,354,63,35,152,196,1469
Bojan Bogdanovic,SF,25,BRK,78,28,1854,261,576,91,256,170,320,87,106,50,163,213,68,34,9,78,104,700
Boris Diaw,PF,32,SAS,81,15,1984,291,632,54,169,237,463,72,93,78,270,348,233,36,23,126,148,708
Bradley Beal,SG,21,WAS,63,59,2107,363,851,106,259,257,592,130,166,57,184,241,194,76,18,123,136,962
Brandan Wright,PF,27,TOT,75,7,1449,233,363,0,3,233,360,78,112,128,193,321,41,50,94,34,102,544
Brandon Bass,PF,29,BOS,82,43,1929,344,683,9,32,335,651,169,214,139,259,398,104,41,32,83,140,866
Brandon Davies,PF,23,TOT,27,6,423,55,137,8,34,47,103,24,37,38,45,83,30,18,7,29,59,142
Brandon Jennings,PG,25,DET,41,41,1173,218,543,76,211,142,332,120,143,21,83,104,272,44,4,90,64,632
Brandon Knight,PG-SG,23,TOT,63,61,2035,375,888,125,321,250,567,195,223,28,216,244,330,90,10,189,114,1070
Brandon Rush,SG,29,GSW,33,0,271,11,54,3,27,8,27,5,11,4,37,41,12,5,12,11,27,30
Brendan Haywood,C,35,CLE,22,1,119,14,30,0,0,14,30,7,13,6,23,29,2,2,10,10,17,35
Brian Roberts,PG,29,CHO,72,10,1330,176,452,62,193,114,259,66,74,13,96,109,162,33,6,57,75,480
Brook Lopez,C,26,BRK,72,44,2100,506,987,1,10,505,977,223,274,214,321,535,50,43,126,104,206,1236
Bruno Caboclo,SF,19,TOR,8,0,23,4,12,2,3,2,9,0,0,1,1,2,0,0,1,4,3,10
Bryce Cotton,PG,22,UTA,15,0,159,29,69,7,20,22,49,15,18,3,15,18,15,4,0,12,6,80
C.J. McCollum,SG,23,POR,62,3,973,159,365,55,139,104,226,51,73,14,77,91,64,43,8,48,81,424
C.J. Miles,SG,27,IND,70,40,1841,329,827,154,446,175,381,130,161,18,196,214,75,60,26,73,132,942
C.J. Watson,PG,30,IND,57,21,1422,181,417,70,175,111,242,138,167,18,145,163,208,57,9,100,107,570
C.J. Wilcox,SG,24,LAC,21,0,101,16,38,7,19,9,19,2,2,1,6,7,8,3,1,10,7,41
Cameron Bairstow,PF,24,CHI,18,1,64,3,14,0,0,3,14,4,5,6,2,8,1,2,1,3,8,10
Carl Landry,PF,31,SAC,70,15,1192,190,369,0,0,190,369,123,150,99,169,268,26,15,17,54,132,503
Carlos Boozer,PF,33,LAL,71,26,1692,371,743,0,0,371,743,94,150,111,371,482,95,41,12,92,184,836
Carmelo Anthony,SF,30,NYK,40,40,1428,358,806,61,179,297,627,189,237,72,192,264,122,40,17,89,87,966
Caron Butler,SF,34,DET,78,21,1623,161,396,83,219,78,177,55,61,21,175,196,79,43,4,49,120,460
Cartier Martin,SF,30,DET,23,0,198,15,53,6,33,9,20,0,0,0,20,20,11,3,1,5,20,36
Chandler Parsons,SF,26,DAL,66,66,2186,383,829,132,347,251,482,139,193,64,259,323,161,69,19,96,140,1037
Channing Frye,PF,31,ORL,75,51,1870,191,487,136,346,55,141,31,35,27,266,293,94,47,39,78,191,549
Charlie Villanueva,PF,30,DAL,64,1,678,150,362,83,221,67,141,20,35,30,119,149,19,15,22,28,64,403
Chase Budinger,SF,26,MIN,67,4,1286,169,390,52,143,117,247,67,81,33,165,198,64,44,10,49,72,457
Chris Andersen,C,36,MIA,60,20,1132,120,207,4,13,116,194,76,114,76,223,299,43,26,61,40,88,320
Chris Bosh,C,30,MIA,44,44,1556,343,745,63,168,280,577,179,232,46,264,310,95,41,25,95,69,928
Chris Copeland,SF,30,IND,50,12,828,112,310,52,167,60,143,33,45,23,88,111,51,11,11,59,78,309
Chris Douglas-Roberts,SG,28,LAC,12,0,103,5,21,1,7,4,14,8,8,1,11,12,4,1,0,0,14,19
Chris Johnson,SF,24,TOT,29,2,526,62,154,28,95,34,59,14,16,8,47,55,15,26,7,15,44,166
Chris Kaman,C,32,POR,74,13,1398,283,549,0,0,283,549,72,102,149,335,484,65,18,54,108,140,638
Chris Paul,PG,29,LAC,82,82,2857,568,1170,139,349,429,821,289,321,52,324,376,838,156,15,190,203,1564
Chuck Hayes,C,31,TOR,29,0,255,22,46,0,0,22,46,6,11,18,33,51,20,10,4,8,37,50
Cleanthony Early,SF,23,NYK,39,7,647,76,214,22,84,54,130,36,48,22,75,97,36,24,12,40,57,210
Clint Capela,C,20,HOU,12,0,90,14,29,0,0,14,29,4,23,10,26,36,2,1,9,5,14,32
Cody Zeller,C,22,CHO,62,45,1487,172,373,1,1,171,372,127,164,97,265,362,100,34,49,62,156,472
Cole Aldrich,C,26,NYK,61,16,976,144,301,0,0,144,301,50,64,101,237,338,75,37,65,59,122,338
Corey Brewer,SF,28,TOT,80,17,2087,343,805,63,235,280,570,168,226,80,217,297,173,114,19,131,173,917
Cory Jefferson,PF,24,BRK,50,1,531,75,167,2,15,73,152,31,54,47,98,145,16,10,21,20,61,183
Cory Joseph,PG,23,SAS,79,14,1444,207,411,16,44,191,367,105,143,44,148,192,188,46,17,67,105,535
Courtney Lee,SG,29,MEM,77,74,2354,288,643,90,224,198,419,111,129,21,157,178,151,75,12,78,129,777
D.J. Augustin,PG,27,TOT,82,14,1964,258,647,83,246,175,401,178,205,20,141,161,353,49,3,145,93,777
Dahntay Jones,SF,34,LAC,33,0,123,6,21,0,4,6,17,9,11,1,10,11,2,3,0,1,23,21
Damian Lillard,PG,24,POR,82,82,2925,590,1360,196,572,394,788,344,398,49,329,378,507,97,21,222,164,1720
Damjan Rudez,SF,28,IND,68,2,1047,119,263,69,170,50,93,16,23,8,39,47,53,16,5,47,79,323
Danilo Gallinari,SF,26,DEN,59,27,1426,228,568,107,301,121,267,171,191,31,187,218,83,47,20,57,94,734
Danny Granger,SF,31,MIA,30,6,613,65,162,30,84,35,78,28,37,20,60,80,17,13,6,24,67,188
Danny Green,SG,27,SAS,81,80,2312,322,738,191,457,131,281,111,127,54,289,343,158,101,87,93,163,946
Dante Cunningham,PF,27,NOP,66,27,1652,155,339,1,10,154,329,29,47,70,186,256,50,46,37,35,101,340
Dante Exum,PG,19,UTA,82,41,1817,145,416,83,264,62,152,20,32,27,104,131,198,41,14,118,147,393
Darius Miller,SF,24,NOP,5,1,43,1,7,0,1,1,6,0,0,0,1,1,2,1,0,1,8,2
Darius Morris,PG,24,BRK,38,0,299,36,106,7,33,29,73,4,9,7,20,27,48,9,0,21,20,83
Darrell Arthur,PF,26,DEN,58,4,988,155,384,26,110,129,274,46,59,53,118,171,57,48,26,47,146,382
Darren Collison,PG,27,SAC,45,45,1565,260,550,60,161,200,389,145,184,19,124,143,252,67,14,112,95,725
David Lee,PF,31,GSW,49,4,904,160,313,0,2,160,311,68,104,81,176,257,85,31,26,49,83,388
David Stockton,PG,23,SAC,3,0,33,2,6,1,2,1,4,3,6,0,2,2,9,2,0,4,1,8
David Wear,PF,24,SAC,2,0,7,0,2,0,1,0,1,0,0,2,0,2,1,0,0,0,1,0
David West,PF,34,IND,66,66,1895,323,686,4,20,319,666,119,161,108,341,449,223,48,48,120,160,769
DeAndre Jordan,C,26,LAC,82,82,2820,379,534,1,4,378,530,187,471,397,829,1226,61,81,183,109,245,946
DeJuan Blair,PF,25,WAS,29,0,180,26,57,0,0,26,57,4,6,16,40,56,3,7,1,13,41,56
DeMar DeRozan,SG,25,TOR,60,60,2100,409,990,25,88,384,902,361,434,41,236,277,210,73,11,137,122,1204
DeMarcus Cousins,C,24,SAC,59,59,2013,498,1066,2,8,496,1058,423,541,185,562,747,210,90,103,254,241,1421
DeMarre Carroll,SF,28,ATL,70,69,2189,318,653,120,304,198,349,127,181,99,273,372,118,94,17,75,154,883
Dennis Schroder,PG,21,ATL,77,10,1516,284,665,52,148,232,517,148,179,29,135,164,317,49,4,150,127,768
Deron Williams,PG,30,BRK,68,55,2114,298,771,87,237,211,534,201,241,29,208,237,448,64,17,154,157,884
Derrick Favors,PF,23,UTA,74,74,2280,482,918,1,6,481,912,222,332,196,411,607,112,60,123,121,210,1187
Derrick Rose,PG,26,CHI,51,51,1530,338,835,76,271,262,564,152,187,35,126,161,251,36,16,161,63,904
Derrick Williams,PF,23,SAC,74,6,1462,217,485,49,156,168,329,134,196,41,161,202,50,34,4,56,67,617
Devin Harris,PG,31,DAL,76,3,1685,219,524,95,266,124,258,132,162,13,122,135,237,78,14,85,147,665
Devyn Marble,SG,22,ORL,16,7,208,14,44,4,22,10,22,5,16,5,26,31,17,9,2,9,14,37
Dewayne Dedmon,C,25,ORL,59,15,845,91,162,0,1,91,161,34,64,118,177,295,9,16,50,51,141,216
Dion Waiters,SG,23,TOT,80,23,2208,375,946,73,246,302,700,117,172,41,151,192,163,90,21,113,155,940
Dirk Nowitzki,PF,36,DAL,77,77,2282,487,1062,104,274,383,788,255,289,44,413,457,143,39,33,82,160,1333
Donald Sloan,PG,27,IND,53,21,1107,145,355,41,131,104,224,60,77,12,131,143,190,23,0,65,47,391
Donatas Motiejunas,PF,24,HOU,71,62,2037,353,700,49,133,304,567,100,166,137,284,421,130,56,34,123,203,855
Dorell Wright,SF,29,POR,48,2,592,72,190,41,108,31,82,34,42,14,97,111,41,20,11,18,55,219
Doug McDermott,SF,23,CHI,36,0,321,43,107,13,41,30,66,10,15,6,37,43,6,4,1,17,29,109
Draymond Green,PF,24,GSW,79,79,2490,339,765,111,329,228,436,132,200,114,533,647,291,123,99,133,253,921
Drew Gooden,PF,33,WAS,51,7,864,110,276,23,59,87,217,34,44,72,151,223,49,21,9,28,91,277
Drew Gordon,PF,24,PHI,9,0,71,8,19,0,3,8,16,1,2,7,11,18,2,1,0,8,7,17
Dwight Buycks,PG,25,LAL,6,0,123,18,40,7,11,11,29,9,10,2,10,12,14,3,0,12,3,52
Dwight Howard,C,29,HOU,41,41,1223,251,423,1,2,250,421,143,271,110,321,431,50,28,53,115,137,646
Dwight Powell,PF,23,TOT,29,0,236,31,67,3,11,28,56,25,33,18,32,50,9,9,6,11,40,90
Dwyane Wade,SG,33,MIA,62,62,1971,509,1084,29,102,480,982,284,370,58,161,219,299,73,21,209,105,1331
E'Twaun Moore,SG,25,CHI,56,0,504,62,139,13,38,49,101,12,20,12,34,46,33,20,6,14,45,149
Earl Barron,C,33,PHO,16,1,143,12,39,2,4,10,35,6,12,14,14,28,5,4,2,5,26,32
Earl Clark,PF,27,BRK,10,0,93,11,30,4,14,7,16,1,4,1,22,23,3,3,4,6,12,27
Ed Davis,PF,25,LAL,79,24,1840,282,469,0,0,282,469,92,189,230,370,600,94,49,98,58,202,656
Ekpe Udoh,PF,27,LAC,33,0,128,11,24,0,0,11,24,7,9,7,19,26,8,8,7,7,20,29
Elfrid Payton,PG,20,ORL,82,63,2489,301,708,11,42,290,666,118,214,107,242,349,533,142,20,203,193,731
Elijah Millsap,SG,27,UTA,47,5,924,81,238,28,90,53,148,58,86,28,122,150,58,56,16,67,124,248
Elliot Williams,SG,25,TOT,13,0,119,14,37,8,18,6,19,1,4,0,8,8,12,4,0,4,12,37
Elton Brand,C,35,ATL,36,4,486,42,95,0,1,42,94,12,23,28,72,100,22,17,25,18,54,96
Enes Kanter,C,22,TOT,75,74,2135,482,928,16,45,466,883,183,234,277,394,671,55,36,29,145,189,1163
Eric Bledsoe,PG,25,PHO,81,81,2800,468,1046,88,272,380,774,353,441,72,351,423,493,127,45,274,189,1377
Eric Gordon,SG,26,NOP,61,60,2018,285,694,141,315,144,379,107,133,28,131,159,229,50,14,122,145,818
Eric Moreland,PF,23,SAC,3,0,2,1,1,0,0,1,1,0,0,0,1,1,0,0,0,0,1,2
Erick Green,PG,23,DEN,43,1,410,61,162,14,47,47,115,10,12,7,24,31,39,12,0,14,26,146
Ersan Ilyasova,PF,27,MIL,58,36,1319,263,557,74,190,189,367,69,107,80,197,277,56,36,19,45,149,669
Evan Fournier,SG,22,ORL,58,32,1661,253,575,85,225,168,350,107,147,28,125,153,120,40,2,82,116,698
Evan Turner,SG,26,BOS,82,57,2260,320,746,33,119,287,627,106,141,40,377,417,449,83,19,198,180,779
Festus Ezeli,C,25,GSW,46,7,504,76,139,0,0,76,139,49,78,60,95,155,9,7,42,32,77,201
Francisco Garcia,SF,33,HOU,14,0,200,17,63,10,45,7,18,1,4,3,14,17,15,9,5,10,20,45
Furkan Aldemir,PF,23,PHI,41,9,540,40,78,0,5,40,73,13,27,78,98,176,28,17,16,17,96,93
Gal Mekel,PG,26,NOP,4,0,43,3,20,0,3,3,17,0,0,0,1,1,13,2,0,2,1,6
Garrett Temple,SG,28,WAS,52,18,735,68,170,33,88,35,82,35,48,24,66,90,56,42,9,34,76,204
Gary Harris,SG,20,DEN,55,6,719,66,217,21,103,45,114,35,47,21,43,64,29,39,7,38,71,188
Gary Neal,SG,30,TOT,54,1,1193,188,503,50,164,138,339,117,135,14,115,129,100,23,1,65,88,543
George Hill,PG,28,IND,43,36,1267,255,535,69,193,186,342,113,143,25,154,179,220,44,14,69,111,692
Gerald Green,SG,29,PHO,74,4,1446,324,778,137,387,187,391,99,120,33,153,186,91,42,12,104,145,884
Gerald Henderson,SG,27,CHO,80,72,2315,370,847,45,136,325,711,184,217,36,237,273,206,51,22,110,135,969
Gerald Wallace,SF,32,BOS,32,0,286,14,34,1,3,13,31,6,15,17,40,57,11,15,4,18,19,35
Giannis Antetokounmpo,SG,20,MIL,81,71,2541,383,780,7,44,376,736,257,347,100,442,542,207,73,85,173,254,1030
Glen Davis,PF,29,LAC,74,0,904,117,255,0,4,117,251,60,95,43,126,169,39,41,21,39,132,294
Glen Rice,SG,24,WAS,5,0,43,3,15,1,7,2,8,4,6,2,2,4,2,0,0,2,11,11
Glenn Robinson,SG-SF,21,TOT,35,1,261,26,67,5,19,21,48,16,24,15,24,39,11,6,1,11,15,73
Goran Dragic,SG-PG,28,TOT,78,78,2640,502,1002,90,259,412,743,181,234,81,193,274,350,78,15,173,195,1275
Gordon Hayward,SF,24,UTA,76,76,2618,484,1087,120,330,364,757,375,462,54,319,373,313,108,30,206,131,1463
Gorgui Dieng,C,25,MIN,73,49,2193,259,512,1,6,258,506,191,244,223,386,609,146,71,126,126,188,710
Grant Jerrett,PF,21,TOT,8,0,51,7,26,1,15,6,11,1,1,2,7,9,3,2,2,3,11,16
Greg Monroe,PF,24,DET,69,57,2137,423,853,0,0,423,853,252,336,229,475,704,142,78,34,149,148,1098
Greg Smith,PF,24,DAL,42,2,363,30,49,0,0,30,49,20,39,26,53,79,9,7,11,11,53,80
Greg Stiemsma,C,29,TOR,17,0,66,6,8,0,0,6,8,2,4,9,6,15,3,2,0,7,15,14
Greivis Vasquez,PG,28,TOR,82,29,1991,296,725,133,351,163,374,50,66,22,194,216,302,46,10,119,177,775
Harrison Barnes,SF,22,GSW,82,82,2318,316,656,87,215,229,441,108,150,117,336,453,116,61,19,71,146,827
Hassan Whiteside,C,25,MIA,48,32,1142,243,387,0,0,243,387,78,156,145,337,482,6,27,123,58,129,564
Hedo Turkoglu,SF,35,LAC,62,2,705,83,188,60,139,23,49,6,11,5,94,99,37,19,7,29,66,232
Henry Sims,C,24,PHI,73,32,1399,238,502,4,22,234,480,106,137,121,238,359,79,39,30,99,135,586
Henry Walker,SF,27,MIA,24,13,628,58,168,45,132,13,36,14,18,7,75,82,29,24,9,24,76,175
Hollis Thompson,SG,23,PHI,71,23,1776,224,543,115,287,109,256,63,89,53,145,198,85,57,26,66,141,626
Ian Clark,SG,23,TOT,30,0,192,19,55,10,30,9,25,9,9,4,12,16,12,9,3,9,20,57
Ian Mahinmi,C,28,IND,61,6,1146,117,212,0,0,117,212,31,102,105,251,356,33,30,46,59,172,265
Iman Shumpert,SG,24,TOT,62,25,1545,193,471,67,196,126,275,43,64,55,169,224,135,81,16,91,138,496
Isaiah Canaan,PG,23,TOT,47,21,938,146,378,91,246,55,132,49,60,18,69,87,98,29,3,62,83,432
Isaiah Thomas,PG,25,TOT,67,1,1726,335,797,129,346,206,451,302,348,33,120,153,284,57,5,143,150,1101
Ish Smith,PG,26,TOT,55,14,832,143,367,18,60,125,307,34,57,15,85,100,180,36,6,78,50,338
J.J. Barea,PG,30,DAL,77,10,1362,225,536,54,167,171,369,76,94,23,111,134,263,33,1,70,104,580
J.J. Hickson,C,26,DEN,73,8,1411,218,459,0,2,218,457,116,201,150,302,452,57,36,35,96,136,552
J.J. Redick,SG,30,LAC,78,78,2409,447,938,200,458,247,480,183,203,22,145,167,137,39,8,95,134,1277
J.R. Smith,SG,29,TOT,70,51,2080,315,755,163,426,152,329,54,72,30,188,218,195,82,22,97,163,847
Jabari Brown,SG,22,LAL,19,5,568,70,170,23,62,47,108,64,85,3,33,36,40,12,2,32,33,227
Jabari Parker,PF,19,MIL,25,25,738,129,263,4,16,125,247,46,66,50,88,138,42,31,5,47,42,308
Jack Cooley,C,23,UTA,16,0,87,9,22,0,0,9,22,9,21,10,15,25,1,6,3,3,23,27
Jae Crowder,SF,24,TOT,82,17,1647,229,545,61,208,168,337,109,141,72,221,293,94,72,25,49,137,628
JaKarr Sampson,SF,21,PHI,74,32,1131,146,346,31,127,115,219,63,94,35,128,163,77,38,26,76,135,386
Jamaal Franklin,SG,23,DEN,3,0,13,1,2,1,2,0,0,0,0,1,1,2,3,0,1,3,4,3
Jamal Crawford,SG,34,LAC,64,4,1703,332,839,119,364,213,475,227,252,18,106,124,158,59,14,92,108,1010
Jameer Nelson,PG,32,TOT,63,29,1407,205,504,89,258,116,246,24,36,33,113,146,253,47,6,109,136,523
James Ennis,SF,24,MIA,62,3,1051,101,247,31,95,70,152,79,94,51,125,176,48,25,17,39,89,312
James Harden,SG,25,HOU,81,81,2981,647,1470,208,555,439,915,715,824,75,384,459,565,154,60,321,208,2217
James Johnson,PF,27,TOR,70,17,1370,238,404,11,51,227,353,67,102,61,196,257,95,54,70,79,155,554
James Jones,SF,34,CLE,57,2,669,74,201,63,175,11,26,39,46,9,53,62,24,13,8,13,67,250
James Michael McAdoo,PF,22,GSW,15,0,137,24,44,0,0,24,44,14,25,15,22,37,2,5,9,6,21,62
James Young,SG,19,BOS,31,0,332,36,102,17,66,19,36,16,29,9,33,42,13,8,2,5,22,105
JaMychal Green,PF,24,TOT,24,1,164,27,47,0,6,27,41,8,10,19,26,45,4,5,5,14,25,62
Jannero Pargo,PG,35,CHO,9,0,73,15,35,9,22,6,13,2,2,0,3,3,8,0,0,3,8,41
Jared Cunningham,SG,23,LAC,19,0,89,12,33,4,13,8,20,7,13,1,8,9,10,3,0,7,12,35
Jared Dudley,SG,29,MIL,72,22,1717,198,423,74,192,124,231,48,67,45,175,220,130,72,11,62,113,518
Jared Sullinger,PF,22,BOS,58,49,1566,311,708,52,184,259,524,96,129,147,294,441,134,44,42,78,153,770
Jarnell Stokes,PF,21,MEM,19,2,126,21,37,0,0,21,37,15,28,16,18,34,4,5,5,7,25,57
Jarrett Jack,PG,31,BRK,80,27,2241,359,817,39,146,320,671,200,227,19,226,245,373,75,13,191,143,957
Jason Maxiell,PF,31,CHO,61,0,878,81,192,0,0,81,192,41,71,86,117,203,19,18,44,29,96,203
Jason Richardson,SG,34,PHI,19,15,416,62,178,31,96,31,82,17,22,13,53,66,38,13,3,16,28,172
Jason Smith,C,28,NYK,82,31,1785,257,592,15,42,242,550,127,153,98,226,324,140,32,44,104,205,656
Jason Terry,SG,37,HOU,77,18,1641,188,446,126,323,62,123,39,48,15,106,121,147,66,19,74,116,541
Jason Thompson,PF,28,SAC,81,63,1991,201,428,0,1,201,427,89,143,139,391,530,85,33,57,84,239,491
JaVale McGee,C,27,TOT,23,0,256,42,79,0,0,42,79,22,33,18,43,61,3,2,20,18,30,106
Jeff Adrien,PF,28,MIN,17,0,215,19,44,0,0,19,44,22,38,23,54,77,15,4,9,9,30,60
Jeff Ayres,PF,27,SAS,51,0,383,55,95,0,0,55,95,27,36,37,80,117,14,8,8,26,60,137
Jeff Green,SF,28,TOT,78,70,2454,416,967,97,292,319,675,239,287,64,264,328,134,53,34,108,147,1168
Jeff Teague,PG,26,ATL,73,72,2228,408,887,71,207,337,680,275,319,30,154,184,513,125,31,205,139,1162
Jeff Withey,C,24,NOP,37,0,259,32,64,0,0,32,64,34,50,23,41,64,11,4,18,12,26,98
Jeffery Taylor,SF,25,CHO,29,13,430,45,114,11,36,34,78,26,41,14,39,53,22,12,1,19,36,127
Jerami Grant,SF,20,PHI,65,11,1377,124,352,49,156,75,196,114,193,49,149,198,79,40,68,85,144,411
Jerel McNeal,PG,27,PHO,6,0,36,3,11,1,2,2,9,2,2,0,3,3,2,3,1,5,5,9
Jeremy Evans,SF,27,UTA,38,0,266,32,58,2,5,30,53,24,29,26,45,71,13,11,12,5,29,90
Jeremy Lamb,SG,22,OKC,47,8,633,104,250,38,111,66,139,49,55,8,99,107,44,21,6,27,52,295
Jeremy Lin,PG,26,LAL,74,30,1907,277,654,65,176,212,478,213,268,26,170,196,339,82,32,166,189,832
Jerome Jordan,C,28,BRK,44,0,383,50,94,0,0,50,94,38,44,52,53,105,13,8,15,22,58,138
Jerrelle Benimon,PF,23,UTA,2,0,3,0,0,0,0,0,0,0,0,1,2,3,0,0,0,1,0,0
Jerryd Bayless,PG,26,MIL,77,4,1717,220,516,37,120,183,396,121,137,22,189,211,233,59,12,133,163,598
Jimmer Fredette,PG,25,NOP,50,0,509,63,166,9,48,54,118,43,45,8,32,40,58,15,2,33,43,178
Jimmy Butler,SG,25,CHI,65,65,2513,421,912,73,193,348,719,386,463,114,265,379,212,114,36,93,108,1301
Joakim Noah,C,29,CHI,67,67,2049,190,427,0,2,190,425,105,174,219,427,646,312,48,74,123,203,485
Jodie Meeks,SG,27,DET,60,0,1462,222,534,74,212,148,322,145,160,12,92,104,79,59,6,57,76,663
Joe Harris,SG,23,CLE,51,1,493,48,120,31,84,17,36,9,15,7,34,41,26,7,2,27,62,136
Joe Ingles,SF,27,UTA,79,32,1673,147,354,72,202,75,152,30,40,22,153,175,182,72,10,98,124,396
Joe Johnson,SG,33,BRK,80,80,2791,446,1025,121,337,325,688,141,176,53,331,384,292,59,14,137,120,1154
Joel Anthony,C,32,DET,49,0,406,36,62,0,0,36,62,15,22,32,61,93,5,12,49,12,55,87
Joel Freeland,C,27,POR,48,8,617,74,151,0,0,74,151,21,25,62,129,191,16,9,23,23,93,169
Joey Dorsey,PF,31,HOU,69,17,854,80,145,0,1,80,144,24,83,103,176,279,25,40,25,41,157,184
Joffrey Lauvergne,C,23,DEN,24,1,268,36,89,3,16,33,73,18,28,27,50,77,13,8,10,22,43,93
John Henson,C,24,MIL,67,11,1228,196,346,0,0,196,346,78,137,124,188,312,59,28,135,87,152,470
John Jenkins,SG,23,ATL,24,3,297,49,99,21,52,28,47,16,19,2,37,39,13,10,0,8,15,135
John Lucas III,PG,32,DET,21,0,272,42,104,9,29,33,75,5,5,4,12,16,60,8,0,16,18,98
John Salmons,SF,35,NOP,21,0,270,16,48,8,26,8,22,2,4,4,17,21,13,9,4,5,25,42
John Wall,PG,24,WAS,79,79,2837,519,1166,65,217,454,949,284,362,36,330,366,792,138,45,304,180,1387
Johnny O'Bryant,PF,21,MIL,34,15,368,44,120,0,0,44,120,12,27,26,38,64,17,5,4,25,44,100
Jon Leuer,PF,25,MEM,63,6,824,121,273,7,29,114,244,37,59,50,157,207,46,17,9,35,86,286
Jonas Jerebko,PF,27,TOT,75,0,1230,169,379,54,140,115,239,56,66,93,189,282,71,46,18,44,135,448
Jonas Valanciunas,C,22,TOR,80,80,2096,373,652,0,1,373,651,217,276,215,478,693,39,33,95,109,222,963
Jordan Adams,SG,20,MEM,30,0,248,35,86,10,25,25,61,14,23,9,19,28,16,16,7,14,24,94
Jordan Clarkson,PG,22,LAL,59,38,1476,267,596,38,121,229,475,131,158,56,135,191,206,51,12,96,109,703
Jordan Farmar,PG,28,LAC,36,0,529,61,158,35,97,26,61,10,11,8,34,42,67,20,5,32,52,167
Jordan Hamilton,SF,24,LAC,14,2,122,14,35,10,21,4,14,0,0,2,14,16,7,2,0,4,14,38
Jordan Hill,C,27,LAL,70,57,1874,357,777,3,11,354,766,124,168,174,382,556,103,34,52,106,164,841
Jorge Gutierrez,PG,26,TOT,20,1,175,22,41,0,3,22,38,9,13,5,20,25,22,6,0,12,25,53
Jose Calderon,PG,33,NYK,42,42,1270,147,354,59,142,88,212,29,32,19,105,124,198,31,0,75,76,382
Josh McRoberts,PF,27,MIA,17,4,296,28,53,8,19,20,34,8,13,7,38,45,33,12,3,22,41,72
Josh Smith,PF,29,TOT,83,35,2300,414,987,72,228,342,759,127,255,152,378,530,277,87,116,206,228,1027
Jrue Holiday,PG,24,NOP,40,37,1303,238,534,51,135,187,399,65,76,32,103,135,274,63,23,91,110,592
Julius Randle,PF,20,LAL,1,0,14,1,3,0,0,1,3,0,2,0,0,0,0,0,0,1,1,2
Justin Hamilton,C,24,TOT,41,14,712,85,178,10,31,75,147,39,47,57,77,134,36,27,30,26,70,219
Justin Holiday,SG,25,GSW,59,4,657,91,235,35,109,56,126,37,45,12,61,73,48,40,12,29,54,254
Jusuf Nurkic,C,20,DEN,62,27,1103,171,383,0,2,171,381,84,132,125,257,382,50,52,68,86,207,426
K.J. McDaniels,SG,21,TOT,62,15,1352,172,434,43,150,129,284,100,133,65,135,200,72,44,70,105,126,487
Kalin Lucas,PG,25,MEM,1,0,6,0,1,0,0,0,1,0,0,0,0,0,0,1,0,0,1,0
Kawhi Leonard,SF,23,SAS,64,64,2033,394,822,67,192,327,630,202,252,85,376,461,161,148,48,97,128,1057
Kelly Olynyk,C,23,BOS,64,13,1423,251,528,61,175,190,353,93,136,92,211,303,109,64,39,98,213,656
Kemba Walker,PG,24,CHO,62,58,2119,378,981,85,280,293,701,234,283,35,185,220,318,89,31,100,92,1075
Kendall Marshall,PG,23,MIL,28,3,417,46,101,18,46,28,55,8,9,2,26,28,86,21,0,35,26,118
Kendrick Perkins,C,30,TOT,68,3,1148,102,227,0,1,102,226,42,83,91,229,320,51,16,42,95,162,246
Kenneth Faried,PF,25,DEN,75,71,2086,373,736,1,8,372,728,199,288,242,426,668,89,62,57,118,211,946
Kent Bazemore,SG,25,ATL,75,10,1324,141,331,48,132,93,199,60,100,21,201,222,78,52,33,73,127,390
Kentavious Caldwell-Pope,SG,21,DET,82,82,2587,390,972,153,444,237,528,110,158,46,209,255,109,93,18,94,161,1043
Kenyon Martin,PF,37,MIL,11,0,104,9,22,0,0,9,22,2,2,6,13,19,5,5,6,3,13,20
Kevin Durant,SF,26,OKC,27,27,913,238,467,64,159,174,308,146,171,16,162,178,110,24,25,74,40,686
Kevin Garnett,PF,38,TOT,47,47,952,143,306,1,7,142,299,36,45,48,263,311,77,46,17,46,109,323
Kevin Love,PF,26,CLE,75,75,2532,413,952,144,392,269,560,258,321,142,589,731,168,51,39,122,140,1228
Kevin Martin,SG,31,MIN,39,36,1302,267,625,75,191,192,434,170,193,19,123,142,89,33,1,76,76,779
Kevin Seraphin,C,25,WAS,79,0,1235,231,450,0,2,231,448,58,82,87,201,288,59,10,59,98,197,520
Khris Middleton,SF,23,MIL,79,58,2378,406,869,109,268,297,601,134,156,48,299,347,182,122,11,113,183,1055
Kirk Hinrich,SG,34,CHI,66,22,1610,142,381,58,168,84,213,35,50,20,101,121,148,46,14,73,144,377
Klay Thompson,SG,24,GSW,77,77,2455,602,1299,239,545,363,754,225,256,27,220,247,222,87,60,149,122,1668
Kobe Bryant,SG,36,LAL,35,35,1207,266,713,54,184,212,529,196,241,26,173,199,197,47,7,128,65,782
Kosta Koufos,C,25,MEM,81,3,1348,182,358,0,0,182,358,55,85,121,305,426,37,29,63,69,148,419
Kostas Papanikolaou,SF,24,HOU,43,1,795,69,197,31,106,38,91,13,18,39,79,118,85,29,13,55,71,182
Kris Humphries,PF,29,WAS,64,17,1345,211,446,0,7,211,439,87,117,118,298,416,57,34,25,46,130,509
Kyle Anderson,SF,21,SAS,33,8,358,31,89,3,11,28,78,9,14,5,67,72,28,15,7,10,28,74
Kyle Korver,SG,33,ATL,75,75,2418,292,600,221,449,71,151,106,118,15,289,304,196,52,42,107,140,911
Kyle Lowry,PG,28,TOR,70,70,2414,430,1043,132,391,298,652,252,312,54,274,328,473,109,13,173,212,1244
Kyle O'Quinn,PF,24,ORL,51,17,824,119,242,12,43,107,199,44,57,46,153,199,59,31,39,55,110,294
Kyle Singler,SF,26,TOT,80,58,1743,172,446,96,241,76,205,40,52,33,161,194,85,47,21,55,153,480
Kyrie Irving,PG,22,CLE,75,75,2730,578,1235,157,378,421,857,315,365,55,182,237,389,114,20,186,146,1628
LaMarcus Aldridge,PF,29,POR,71,71,2512,659,1415,37,105,622,1310,306,362,177,549,726,124,48,68,122,125,1661
Lance Stephenson,SG,24,CHO,61,25,1573,207,550,18,105,189,445,69,110,39,238,277,240,38,8,128,134,501
Lance Thomas,PF-SF,26,TOT,62,37,1490,182,442,7,22,175,420,72,99,65,130,195,69,37,8,74,101,443
Landry Fields,SF,26,TOR,26,9,216,20,41,1,2,19,39,5,6,10,16,26,15,11,0,8,9,46
Langston Galloway,PG,23,NYK,45,41,1457,204,511,62,176,142,335,63,78,37,153,190,150,52,12,61,129,533
Larry Drew,PG,24,PHI,12,1,219,20,58,4,26,16,32,2,3,1,14,15,45,6,0,25,13,46
Larry Sanders,C,26,MIL,27,26,586,86,172,0,0,86,172,24,48,67,99,166,23,26,39,28,104,196
Lavoy Allen,C,25,IND,63,0,1070,141,299,0,0,141,299,33,47,123,200,323,73,15,42,40,102,315
Leandro Barbosa,SG,32,GSW,66,1,982,183,386,43,112,140,274,58,74,23,68,91,99,41,8,44,87,467
LeBron James,SF,30,CLE,69,69,2493,624,1279,120,339,504,940,375,528,51,365,416,511,109,49,272,135,1743
Lester Hudson,SG,30,LAC,5,0,56,6,14,3,6,3,8,3,4,1,7,8,5,6,1,3,4,18
Lorenzo Brown,PG,24,MIN,29,7,549,52,122,6,28,46,94,12,19,14,56,70,90,28,6,30,49,122
Lou Amundson,PF,32,TOT,53,35,937,109,255,0,1,109,254,41,87,94,174,268,70,22,52,62,126,259
Lou Williams,SG,28,TOR,80,0,2016,375,928,152,447,223,481,340,395,24,127,151,164,88,10,101,103,1242
Luc Mbah a Moute,PF,28,PHI,67,61,1916,251,636,62,202,189,434,96,163,82,246,328,106,81,21,99,104,660
Lucas Nogueira,C,22,TOR,6,0,23,2,8,0,0,2,8,2,4,2,9,11,1,2,0,2,6,6
Luigi Datome,SF,27,TOT,21,1,209,43,89,18,40,25,49,1,1,3,26,29,9,2,7,9,15,105
Luis Scola,PF,34,IND,81,16,1659,300,642,5,20,295,622,158,226,138,388,526,105,47,18,94,192,763
Luke Babbitt,SF,25,NOP,63,19,830,92,192,59,115,33,77,13,19,12,99,111,24,17,11,26,63,256
Luke Ridnour,PG,33,ORL,47,0,683,75,176,20,63,55,113,18,21,8,60,68,96,20,4,38,67,188
Luol Deng,SF,29,MIA,72,72,2421,369,787,78,220,291,567,191,251,103,273,376,139,65,22,108,109,1007
Malcolm Lee,SG,24,PHI,1,0,2,0,1,0,0,0,1,0,0,0,0,0,0,0,0,0,0,0
Malcolm Thomas,PF,26,PHI,17,0,194,18,40,0,7,18,33,9,13,16,40,56,7,3,1,13,17,45
Manu Ginobili,SG,37,SAS,70,0,1587,251,589,89,258,162,331,147,204,28,183,211,293,67,20,154,138,738
Marc Gasol,C,30,MEM,81,81,2687,530,1072,3,17,527,1055,350,440,115,515,630,307,70,131,176,208,1413
Marcin Gortat,C,30,WAS,82,82,2453,439,775,0,3,439,772,123,175,180,537,717,97,49,110,100,191,1001
Marco Belinelli,SG,28,SAS,62,9,1388,199,470,86,230,113,240,84,99,26,131,157,94,31,3,61,85,568
Marcus Morris,PF,25,PHO,81,35,2045,331,763,112,313,219,450,71,113,73,312,385,133,63,16,73,188,845
Marcus Smart,PG,20,BOS,67,38,1808,175,477,91,272,84,205,82,127,61,161,222,208,99,18,90,176,523
Marcus Thornton,SG,27,TOT,48,0,721,140,345,54,143,86,202,46,56,23,63,86,36,27,7,27,38,380
Mario Chalmers,PG,28,MIA,80,37,2368,267,663,73,248,194,415,206,266,24,182,206,307,122,10,173,251,813
Markel Brown,SG,23,BRK,47,29,781,76,210,17,64,59,146,47,57,16,91,107,39,31,12,27,57,216
Markieff Morris,PF,25,PHO,82,82,2581,512,1100,57,179,455,921,177,232,110,396,506,192,101,39,170,245,1258
Marreese Speights,C,27,GSW,76,9,1207,318,646,5,18,313,628,150,178,109,216,325,72,20,34,82,189,791
Martell Webster,SF,28,WAS,32,0,352,24,91,10,43,14,48,48,64,10,36,46,17,7,1,22,24,106
Marvin Williams,PF,28,CHO,78,37,2035,210,495,95,265,115,230,62,87,58,328,386,100,69,36,60,146,577
Mason Plumlee,C,24,BRK,82,45,1743,280,489,0,3,280,486,157,317,175,337,512,74,65,63,106,207,717
Matt Barnes,SF,34,LAC,76,74,2271,277,624,136,376,141,248,74,95,51,251,302,114,67,50,87,240,764
Matt Bonner,PF,34,SAS,72,19,935,94,230,46,126,48,104,30,37,29,86,115,47,10,12,11,65,264
Matthew Dellavedova,SG,24,CLE,67,13,1380,111,307,68,167,43,140,29,38,37,89,126,204,24,2,61,152,319
Maurice Harkless,SF,21,ORL,45,4,674,63,158,10,56,53,102,22,41,38,68,106,25,32,9,27,66,158
Meyers Leonard,C,22,POR,55,7,847,125,245,47,112,78,133,30,32,46,204,250,32,10,14,39,113,327
Michael Beasley,PF,26,MIA,24,1,505,92,212,8,34,84,178,20,26,12,77,89,32,15,13,37,66,212
Michael Carter-Williams,PG,23,TOT,66,63,2149,364,919,36,153,328,766,202,291,64,289,353,442,111,30,253,167,966
Michael Kidd-Gilchrist,SF,21,CHO,55,52,1587,224,482,0,0,224,482,150,214,109,307,416,77,30,38,63,115,598
Mike Conley,PG,27,MEM,70,70,2225,393,882,107,277,286,605,214,249,29,180,209,375,89,14,156,139,1107
Mike Dunleavy,SF,34,CHI,63,63,1838,209,481,107,263,102,218,70,87,28,220,248,114,39,21,60,123,595
Mike Miller,SF,34,CLE,52,15,701,37,114,32,98,5,16,3,4,4,87,91,46,14,4,23,74,109
Mike Muscala,PF,23,ATL,40,8,502,83,151,9,22,74,129,22,25,52,67,119,25,16,19,21,52,197
Mike Scott,PF,26,ATL,68,0,1123,201,453,66,192,135,261,61,77,45,154,199,75,25,3,39,83,529
Miles Plumlee,C,26,TOT,73,28,1194,136,254,0,0,136,254,22,46,112,208,320,34,41,66,51,111,294
Miroslav Raduljica,C,27,MIN,5,0,23,3,8,0,0,3,8,2,2,2,3,5,0,1,0,2,8,8
Mirza Teletovic,PF,29,BRK,40,4,892,122,319,62,193,60,126,33,46,27,167,194,46,14,16,53,74,339
Mitch McGary,PF,22,OKC,32,2,485,88,165,0,2,88,163,25,40,53,112,165,14,16,16,31,72,201
Mo Williams,PG,32,TOT,68,33,1980,341,860,119,348,222,512,163,187,22,152,174,424,46,14,172,162,964
Monta Ellis,SG,29,DAL,80,80,2699,602,1354,81,284,521,1070,228,303,34,156,190,329,148,25,198,197,1513
Nate Robinson,PG,30,TOT,42,1,591,88,255,31,112,57,143,31,46,17,33,50,97,20,3,30,76,238
Nate Wolters,PG,23,TOT,21,0,247,20,57,0,7,20,50,2,6,8,26,34,21,8,2,13,18,42
Nazr Mohammed,C,37,CHI,23,0,128,13,30,0,0,13,30,1,3,11,27,38,3,4,5,7,16,27
Nene Hilario,PF,32,WAS,67,58,1693,307,601,1,5,306,596,122,202,84,261,345,123,66,22,124,180,737
Nerlens Noel,C,20,PHI,75,71,2311,302,653,0,0,302,653,140,230,185,426,611,128,133,142,146,208,744
Nick Calathes,SG,25,MEM,58,0,838,104,247,11,43,93,204,24,45,19,87,106,146,63,5,61,100,243
Nick Collison,PF,34,OKC,66,2,1101,106,253,16,60,90,193,45,65,90,160,250,90,35,25,45,156,273
Nick Johnson,SG,22,HOU,28,0,262,26,75,5,21,21,54,17,25,13,26,39,11,7,3,19,34,74
Nick Young,SG,29,LAL,42,0,1000,174,476,83,225,91,251,132,148,17,79,96,41,23,11,44,83,563
Nicolas Batum,SF,26,POR,71,71,2380,240,600,100,309,140,291,84,98,62,354,416,341,78,40,132,106,664
Nik Stauskas,SG,21,SAC,73,1,1127,108,296,48,149,60,147,55,64,11,77,88,67,20,17,40,92,319
Nikola Mirotic,PF,23,CHI,82,3,1654,253,624,99,313,154,311,228,284,63,341,404,97,54,54,89,172,833
Nikola Pekovic,C,29,MIN,31,29,815,139,328,0,0,139,328,108,129,89,145,234,27,19,12,42,59,386
Nikola Vucevic,C,24,ORL,74,74,2529,631,1206,2,6,629,1200,164,218,238,572,810,147,54,54,148,220,1428
Noah Vonleh,PF,19,CHO,25,0,259,30,76,5,13,25,63,18,26,28,58,86,4,4,9,11,20,83
Norris Cole,PG,26,TOT,75,25,1831,230,558,55,176,175,382,58,81,13,146,159,255,57,15,99,124,573
O.J. Mayo,SG,27,MIL,71,15,1697,296,701,99,277,197,424,115,139,30,157,187,197,57,18,128,165,806
Ognjen Kuzmic,C,24,GSW,16,0,72,8,12,0,0,8,12,4,4,7,10,17,6,2,1,5,13,20
Omer Asik,C,28,NOP,76,76,1982,213,412,0,0,213,412,131,225,244,504,748,72,29,54,95,144,557
Omri Casspi,SF,26,SAC,67,19,1416,209,427,35,87,174,340,140,191,54,206,260,102,31,9,88,107,593
Otto Porter,SF,21,WAS,74,13,1432,176,391,35,104,141,287,58,79,70,151,221,65,44,30,52,97,445
P.J. Hairston,SG,22,CHO,45,2,687,87,269,49,163,38,106,31,36,22,70,92,21,21,13,22,61,254
P.J. Tucker,SF,29,PHO,78,63,2383,261,596,87,252,174,344,104,143,114,388,502,122,107,23,96,179,713
Pablo Prigioni,PG,37,TOT,67,3,1197,91,228,57,166,34,62,35,41,30,89,119,171,79,1,62,88,274
Patrick Beverley,PG,26,HOU,56,55,1727,204,532,115,323,89,209,45,60,67,170,237,192,59,23,83,182,568
Patrick Christopher,SG,26,UTA,4,1,29,3,12,0,4,3,8,0,0,2,4,6,0,1,0,1,6,6
Patrick Patterson,PF,25,TOR,81,4,2156,240,535,105,283,135,252,63,80,127,306,433,155,60,44,54,149,648
Patty Mills,PG,26,SAS,51,0,801,128,336,62,182,66,154,33,40,21,54,75,87,28,2,35,58,351
Pau Gasol,PF,34,CHI,78,78,2681,570,1153,12,26,558,1127,294,366,220,699,919,210,25,147,158,147,1446
Paul George,SF,24,IND,6,0,91,18,49,9,22,9,27,8,11,4,18,22,6,5,1,12,11,53
Paul Millsap,PF,29,ATL,73,73,2390,443,930,77,216,366,714,255,337,139,431,570,223,130,69,166,201,1218
Paul Pierce,SF,37,WAS,73,73,1914,293,656,118,303,175,353,164,210,45,249,294,144,46,24,92,160,868
Pero Antic,C,32,ATL,63,3,1037,108,296,52,173,56,123,88,123,58,131,189,49,18,14,49,132,356
Perry Jones,SF,23,OKC,43,13,631,73,184,14,60,59,124,24,37,6,70,76,18,17,8,24,50,184
Phil Pressey,PG,23,BOS,50,0,600,64,174,16,65,48,109,33,49,13,67,80,117,30,6,41,54,177
Quincy Acy,PF,24,NYK,68,22,1287,152,331,18,60,134,271,76,97,79,222,301,68,27,22,60,147,398
Quincy Miller,PF,22,TOT,10,0,119,9,38,3,18,6,20,8,11,4,16,20,8,7,5,5,9,29
Quincy Pondexter,SF-SG,26,TOT,75,30,1793,188,447,91,244,97,203,71,96,53,142,195,94,19,24,51,150,538
Rajon Rondo,PG,28,TOT,68,68,2018,275,645,27,86,248,559,31,78,73,300,373,538,91,7,210,153,608
Ramon Sessions,PG,28,TOT,64,10,1188,125,334,19,60,106,274,133,173,23,121,144,182,29,0,86,73,402
Randy Foye,SG,31,DEN,50,21,1087,148,402,94,263,54,139,45,55,9,76,85,119,34,11,60,97,435
Rasual Butler,SF,35,WAS,75,1,1505,218,517,91,235,127,282,53,67,27,170,197,63,29,22,48,98,580
Ray McCallum,PG,23,SAC,68,30,1436,206,470,34,111,172,359,57,84,52,128,180,188,45,11,85,92,503
Raymond Felton,PG,30,DAL,29,3,281,43,106,10,34,33,72,12,15,2,24,26,41,11,4,18,17,108
Reggie Bullock,SF,23,TOT,36,2,338,24,70,15,46,9,24,6,9,1,49,50,8,10,4,8,19,69
Reggie Evans,PF,34,SAC,47,7,764,58,137,0,2,58,135,60,97,97,202,299,32,22,5,45,91,176
Reggie Jackson,PG,24,TOT,77,40,2268,432,996,72,241,360,755,181,218,56,271,327,462,62,9,186,167,1117
Reggie Williams,SF,28,SAS,20,0,105,15,39,3,19,12,20,4,4,5,12,17,10,1,0,2,12,37
Richard Jefferson,SF,34,DAL,74,18,1244,144,324,66,155,78,169,78,114,25,158,183,61,32,11,52,115,432
Ricky Ledo,SG,22,TOT,17,0,244,32,96,10,27,22,69,16,22,16,20,36,19,6,1,26,21,90
Ricky Rubio,PG,24,MIN,22,22,692,78,219,13,51,65,168,57,71,19,106,125,193,38,1,64,59,226
Robbie Hummel,SF,25,MIN,45,4,742,79,172,16,51,63,121,24,29,31,103,134,27,16,9,18,86,198
Robert Covington,SF,24,PHI,70,49,1956,299,756,167,446,132,310,178,217,65,251,316,105,97,31,128,189,943
Robert Sacre,C,25,LAL,67,18,1133,126,306,0,1,126,305,55,82,89,144,233,55,28,43,36,121,307
Robin Lopez,C,26,POR,59,59,1638,234,437,0,1,234,436,98,127,190,204,394,55,16,84,73,122,566
Rodney Hood,SG,22,UTA,50,21,1064,155,374,62,170,93,204,61,80,9,108,117,83,30,12,45,119,433
Rodney Stuckey,PG,28,IND,71,36,1874,332,754,55,141,277,613,177,216,36,212,248,219,56,10,118,131,896
Ronnie Price,PG,31,LAL,43,20,982,77,223,31,109,46,114,36,45,19,50,69,165,67,4,52,118,221
Ronny Turiaf,C,32,MIN,2,0,19,0,0,0,0,0,0,0,0,0,1,1,2,0,0,0,0,0
Roy Hibbert,C,28,IND,76,76,1926,317,710,0,2,317,708,168,204,156,384,540,84,18,125,107,216,802
Rudy Gay,SF,28,SAC,68,67,2408,508,1116,79,220,429,896,337,393,98,301,399,250,71,41,183,157,1432
Rudy Gobert,C,22,UTA,82,37,2158,258,427,0,2,258,425,170,273,265,510,775,109,64,189,111,175,686
Russ Smith,PG,23,TOT,12,0,65,8,25,2,11,6,14,12,13,1,5,6,8,3,0,12,13,30
Russell Westbrook,PG,26,OKC,67,67,2302,627,1471,86,288,541,1183,546,654,124,364,488,574,140,14,293,184,1886
Ryan Anderson,PF,26,NOP,61,5,1675,291,729,122,359,169,370,129,151,108,187,295,55,33,20,62,113,833
Ryan Hollins,C,30,SAC,46,9,441,53,82,0,0,53,82,31,54,36,67,103,14,6,19,25,65,137
Ryan Kelly,PF,23,LAL,52,34,1233,104,309,45,134,59,175,79,95,13,133,146,92,30,24,37,118,332
Samuel Dalembert,C,33,NYK,32,21,544,57,130,0,0,57,130,14,20,53,115,168,29,14,41,39,70,128
Sean Kilpatrick,SG,25,MIN,4,0,72,7,20,4,13,3,7,4,4,1,5,6,4,3,0,2,3,22
Sebastian Telfair,PG,29,OKC,16,1,327,46,125,18,60,28,65,24,34,2,28,30,45,10,0,18,29,134
Serge Ibaka,PF,25,OKC,64,64,2116,374,786,77,205,297,581,92,110,135,364,499,55,30,155,97,194,917
Sergey Karasev,SG,21,BRK,33,16,555,54,134,16,54,38,80,29,38,22,44,66,46,23,1,24,45,153
Seth Curry,PG,24,PHO,2,0,8,0,3,0,1,0,2,0,0,0,2,2,1,0,0,0,2,0
Shabazz Muhammad,SG,22,MIN,38,13,866,194,397,20,51,174,346,104,145,63,91,154,44,18,7,35,49,512
Shabazz Napier,PG,23,MIA,51,10,1012,87,228,43,118,44,110,44,56,17,96,113,130,40,4,81,76,261
Shane Larkin,PG,22,NYK,76,22,1865,187,432,35,116,152,316,61,78,29,147,176,226,93,9,83,150,470
Shannon Brown,SG,29,MIA,5,2,89,7,19,3,7,4,12,3,4,0,1,1,3,4,0,4,8,20
Shaun Livingston,PG,29,GSW,78,2,1468,198,396,0,2,198,394,65,91,43,140,183,259,49,20,102,110,461
Shavlik Randolph,PF,31,TOT,21,0,126,9,35,0,5,9,30,6,12,16,22,38,4,5,3,3,16,24
Shawn Marion,SF,36,CLE,57,24,1101,119,267,12,46,107,221,26,34,64,138,202,51,27,27,33,58,276
Shawne Williams,SF,28,TOT,63,22,1087,121,300,64,178,57,122,35,40,36,130,166,44,25,21,30,135,341
Shayne Whittington,PF,23,IND,20,0,108,19,42,1,6,18,36,18,23,10,19,29,6,5,2,5,18,57
Shelvin Mack,PG,24,ATL,55,0,833,117,292,40,127,77,165,25,31,8,71,79,155,30,2,49,32,299
Sim Bhullar,C,22,SAC,3,0,3,1,2,0,0,1,2,0,0,0,1,1,1,0,1,0,0,2
Solomon Hill,SF,23,IND,82,78,2381,251,634,68,208,183,426,159,193,70,244,314,184,66,18,115,177,729
Spencer Dinwiddie,PG,21,DET,34,1,455,51,169,12,65,39,104,31,34,4,44,48,104,19,6,33,53,145
Spencer Hawes,PF,26,LAC,73,15,1274,163,415,55,176,108,239,44,68,30,228,258,88,24,53,61,173,425
Stephen Curry,PG,26,GSW,80,80,2613,653,1341,286,646,367,695,308,337,56,285,341,619,163,16,249,158,1900
Steve Blake,PG,34,POR,81,0,1529,122,327,77,219,45,108,29,41,16,121,137,288,41,5,104,118,350
Steve Novak,SF-PF,31,TOT,35,0,197,22,56,19,48,3,8,0,2,2,20,22,11,0,2,5,23,63
Steven Adams,C,21,OKC,70,67,1771,217,399,0,2,217,397,103,205,199,324,523,66,38,86,99,222,537
T.J. Warren,SF,21,PHO,40,1,614,113,214,5,21,108,193,14,19,41,44,85,25,18,9,27,51,245
Taj Gibson,PF,29,CHI,62,17,1692,254,506,0,0,254,506,132,184,162,234,396,71,36,75,77,162,640
Tarik Black,C,23,TOT,63,39,1196,157,273,0,1,157,272,65,118,142,226,368,42,19,24,48,158,379
Tayshaun Prince,SF,34,TOT,58,16,1397,177,402,31,67,146,335,49,65,52,158,210,93,29,16,35,55,434
Terrence Jones,PF,23,HOU,33,24,889,158,299,13,37,145,262,57,94,78,142,220,36,18,59,37,78,386
Terrence Ross,SF,23,TOR,82,61,2092,309,753,145,390,164,363,44,56,32,194,226,86,53,25,69,136,807
Thabo Sefolosha,SF,30,ATL,52,7,976,104,249,25,78,79,171,45,58,53,170,223,75,53,21,38,67,278
Thaddeus Young,PF,26,TOT,76,68,2434,451,968,38,115,413,853,131,200,127,284,411,173,124,25,117,171,1071
Thomas Robinson,PF,23,TOT,54,4,798,126,260,0,2,126,258,56,106,95,208,303,33,32,20,59,104,308
Tiago Splitter,C,30,SAS,52,35,1030,169,303,0,0,169,303,90,120,91,161,252,78,35,37,60,103,428
Tim Duncan,C,38,SAS,77,77,2227,419,819,2,7,417,812,230,311,170,534,704,230,63,151,131,165,1070
Tim Frazier,PG,24,TOT,11,3,239,21,61,5,17,16,44,10,21,6,22,28,60,8,0,25,26,57
Tim Hardaway,SG,22,NYK,70,30,1681,279,717,121,354,158,363,125,156,12,144,156,127,20,14,82,119,804
Timofey Mozgov,C,28,TOT,81,80,2045,314,566,2,6,312,560,155,216,203,388,591,55,33,97,116,227,785
Tobias Harris,SF,22,ORL,68,63,2369,442,949,87,239,355,710,193,245,73,357,430,124,69,36,115,134,1164
Toney Douglas,SG,28,NOP,12,0,177,19,51,5,18,14,33,8,13,2,20,22,24,11,4,10,20,51
Tony Allen,SG,33,MEM,63,41,1648,225,455,10,29,215,426,79,126,103,177,280,86,129,30,86,166,539
Tony Parker,PG,32,SAS,68,68,1953,404,832,38,89,366,743,130,166,15,114,129,335,44,2,146,108,976
Tony Snell,SF,23,CHI,72,22,1412,159,371,73,197,86,174,44,55,31,145,176,62,32,11,48,86,435
Tony Wroten,PG,21,PHI,30,15,895,175,434,37,142,138,292,120,180,22,64,86,157,48,8,113,72,507
Toure' Murry,SG-PG,25,TOT,5,0,18,2,5,0,0,2,5,2,2,1,0,1,1,1,0,4,2,6
Travis Wear,SF,24,NYK,51,1,672,84,209,11,30,73,179,20,26,31,75,106,40,15,11,35,55,199
Trevor Ariza,SF,29,HOU,82,82,2930,366,910,194,555,172,355,122,143,77,382,459,209,152,17,141,186,1048
Trevor Booker,PF,27,UTA,79,5,1564,226,464,29,84,197,380,86,148,139,258,397,83,43,41,88,144,567
Trey Burke,PG,22,UTA,76,43,2288,370,1005,124,390,246,615,109,145,31,173,204,328,65,15,124,119,973
Tristan Thompson,PF,23,CLE,82,15,2194,267,488,0,0,267,488,159,248,274,383,657,39,34,61,83,189,693
Troy Daniels,SG,23,TOT,47,0,397,61,165,43,118,18,47,11,13,8,25,33,22,6,1,20,40,176
Ty Lawson,PG,27,DEN,75,75,2665,404,926,70,205,334,721,265,363,42,192,234,720,92,9,185,128,1143
Tyler Ennis,PG,20,TOT,33,1,411,52,144,12,43,40,101,5,7,7,28,35,73,18,5,42,36,121
Tyler Hansbrough,PF,29,TOR,74,8,1058,86,165,1,7,85,158,97,139,106,159,265,21,30,15,20,141,270
Tyler Johnson,SG,22,MIA,32,2,603,70,167,18,48,52,119,32,47,14,67,81,42,33,9,30,42,190
Tyler Zeller,C,25,BOS,82,59,1731,340,619,0,0,340,619,153,186,146,319,465,113,18,52,76,205,833
Tyreke Evans,SG,25,NOP,79,76,2690,521,1165,69,227,452,938,202,291,82,334,416,521,100,37,246,198,1313
Tyrus Thomas,PF,28,MEM,2,0,7,1,1,0,0,1,1,2,2,0,0,0,1,0,0,0,0,4
Tyson Chandler,C,32,DAL,75,75,2286,293,440,0,0,293,440,185,257,294,570,864,84,42,91,105,169,771
Udonis Haslem,PF,34,MIA,62,25,995,107,239,2,10,105,229,45,64,71,187,258,46,21,13,41,113,261
Vander Blue,SG,22,LAL,2,1,74,9,30,2,10,7,20,2,5,2,7,9,8,3,0,6,4,22
Victor Claver,SF,26,POR,10,0,76,9,20,6,11,3,9,0,0,3,17,20,1,1,1,4,12,24
Victor Oladipo,SG,22,ORL,72,71,2573,473,1086,84,248,389,838,262,320,51,251,302,295,120,19,204,187,1292
Vince Carter,SG,38,MEM,66,1,1091,135,406,69,232,66,174,45,57,27,106,133,79,43,14,43,102,384
Wayne Ellington,SG,27,LAL,65,36,1675,254,617,90,243,164,374,52,64,31,179,210,105,33,2,50,77,650
Wesley Johnson,SF,27,LAL,76,59,2245,286,691,91,259,195,432,90,112,67,252,319,124,59,45,87,162,753
Wesley Matthews,SG,28,POR,60,60,2024,337,752,173,445,164,307,109,145,38,184,222,139,77,10,81,132,956
Will Barton,SG,24,TOT,58,0,983,150,353,23,85,127,268,74,94,26,136,162,81,48,19,61,70,397
Will Bynum,SG,32,WAS,7,0,67,10,31,0,9,10,22,2,4,2,4,6,18,1,1,8,9,22
Will Cherry,PG,23,CLE,8,0,69,5,19,2,9,3,10,3,6,1,4,5,8,6,1,4,10,15
Willie Green,SG,33,ORL,52,2,951,118,306,42,121,76,185,28,34,14,65,79,68,26,5,48,81,306
Wilson Chandler,SF,27,DEN,78,75,2471,418,975,139,406,279,569,110,142,96,379,475,134,58,29,110,231,1085
Xavier Henry,SF,23,LAL,9,0,86,3,13,0,0,3,13,14,24,2,2,4,3,3,0,3,6,20
Zach LaVine,PG,19,MIN,77,40,1902,286,677,57,167,229,510,149,177,27,187,214,276,54,10,193,158,778
Zach Randolph,PF,33,MEM,71,71,2304,454,932,7,20,447,912,228,298,225,522,747,153,69,14,156,175,1143
Zaza Pachulia,C,30,MIL,73,45,1730,240,529,0,3,240,526,126,160,197,303,500,178,80,21,133,170,606
Zoran Dragic,SG,25,TOT,16,1,75,11,30,3,14,8,16,3,5,5,3,8,5,2,0,5,6,28