Player,Pos,Age,Tm,G,GS,MP,FG,FGA,3P,3PA,2P,2PA,FT,FTA,ORB,DRB,TRB,AST,STL,BLK,TOV,PF,PTS
A.J. Price,SG,27,MIN,28,0,99,19,46,6,22,13,24,0,2,1,9,10,13,1,0,7,5,44
Aaron Brooks,PG,29,TOT,72,12,1557,233,581,96,248,137,333,83,95,43,97,140,233,52,13,117,146,645
Aaron Gray,C,29,TOT,37,6,355,27,61,0,1,27,60,11,20,42,69,111,22,10,8,31,64,65
Adonis Thomas,SF,20,TOT,6,1,37,6,14,1,5,5,9,1,1,0,3,3,3,0,0,1,6,14
Al Harrington,PF,33,WAS,34,0,511,82,207,34,100,48,107,27,35,15,65,80,28,14,0,34,72,225
Al Horford,C,27,ATL,29,29,958,238,420,4,11,234,409,58,85,66,178,244,76,27,44,64,56,538
Al Jefferson,C,29,CHA,73,73,2553,700,1376,3,15,697,1361,191,277,156,636,792,155,67,79,124,176,1594
Al-Farouq Aminu,SF,23,NOP,80,65,2045,234,494,13,48,221,446,91,137,129,367,496,114,82,38,88,147,572
Alan Anderson,SF,31,BRK,78,26,1773,194,485,84,248,110,237,92,118,40,135,175,81,48,11,62,147,564
Alec Burks,SG,22,UTA,78,12,2193,380,831,50,143,330,688,279,373,59,198,257,212,69,14,149,190,1089
Alex Len,C,20,PHO,42,3,362,33,78,0,0,33,78,20,31,39,60,99,4,4,18,26,68,86
Alexey Shved,SG,25,MIN,63,0,664,76,237,30,102,46,135,68,90,21,60,81,68,26,16,48,36,250
Alexis Ajinca,C,25,NOP,56,30,951,136,249,0,1,136,248,56,67,94,183,277,40,23,46,63,187,328
Allen Crabbe,SG,21,POR,15,0,100,12,33,6,14,6,19,3,4,1,8,9,6,2,1,3,10,33
Alonzo Gee,SF,26,CLE,65,24,1020,98,236,19,58,79,178,43,61,35,114,149,47,39,15,44,96,258
Amar'e Stoudemire,C,31,NYK,65,21,1466,311,558,0,0,311,558,150,203,112,208,320,34,23,37,91,159,772
Amir Johnson,PF,26,TOR,77,72,2214,344,612,20,66,324,546,91,143,172,333,505,115,56,88,123,271,799
Anderson Varejao,C,31,CLE,65,29,1800,227,459,0,7,227,452,92,135,187,442,629,140,69,39,72,164,546
Andray Blatche,PF,27,BRK,73,7,1618,321,674,15,54,306,620,164,221,120,270,390,112,75,38,110,166,821
Andre Drummond,C,20,DET,81,81,2619,479,769,0,2,479,767,137,328,440,631,1071,35,101,131,110,273,1095
Andre Iguodala,SF,30,GSW,63,63,2040,220,458,62,175,158,283,86,132,53,240,293,263,95,18,100,103,588
Andre Miller,SG,37,TOT,58,2,982,106,231,11,21,95,210,60,77,28,102,130,197,34,9,61,75,283
Andre Roberson,SG,22,OKC,40,16,399,33,68,2,13,31,55,7,10,36,58,94,15,19,10,19,74,75
Andrea Bargnani,C,28,NYK,42,39,1257,222,502,30,108,192,394,84,102,69,153,222,45,14,52,58,100,558
Andrei Kirilenko,PF,32,BRK,45,4,857,82,160,1,5,81,155,61,119,55,91,146,72,40,19,54,65,226
Andrew Bogut,C,29,GSW,67,67,1769,235,375,0,0,235,375,22,64,182,489,671,112,47,121,97,210,492
Andrew Bynum,C,26,TOT,26,19,516,94,225,0,0,94,225,37,49,53,92,145,29,6,29,34,31,225
Andrew Nicholson,PF,24,ORL,76,5,1174,180,420,28,89,152,331,47,57,53,202,255,25,18,23,51,150,435
Andris Biedrins,C,27,UTA,6,0,45,1,1,0,0,1,1,1,6,2,15,17,0,0,0,2,6,3
Antawn Jamison,PF,37,LAC,22,0,248,29,92,8,41,21,51,18,25,9,46,55,7,9,3,7,29,84
Anthony Bennett,PF,20,CLE,52,0,663,80,225,13,53,67,172,44,69,49,106,155,17,21,8,47,93,217
Anthony Davis,PF,20,NOP,67,66,2358,522,1005,2,9,520,996,348,440,207,466,673,105,89,189,109,200,1394
Anthony Morrow,SG,28,NOP,76,9,1426,238,520,88,195,150,325,72,87,29,111,140,59,38,12,51,102,636
Anthony Randolph,PF,24,DEN,43,5,527,68,176,18,61,50,115,52,69,20,102,122,32,26,19,39,64,206
Anthony Tolliver,PF,28,CHA,64,9,1298,129,307,102,247,27,60,33,41,33,135,168,42,19,15,23,82,393
Archie Goodwin,SG,19,PHO,52,0,533,76,167,5,36,71,131,37,55,25,62,87,20,20,11,44,45,194
Arinze Onuaku,PF,26,TOT,5,0,30,1,5,0,0,1,5,1,2,2,6,8,3,0,0,1,3,3
Arnett Moultrie,PF,23,PHI,12,2,187,16,38,0,0,16,38,4,5,11,24,35,2,8,4,7,22,36
Aron Baynes,C,27,SAS,53,4,491,71,163,0,0,71,163,19,21,57,88,145,34,2,5,36,77,161
Arron Afflalo,SG,28,ORL,73,73,2552,464,1011,128,300,336,711,274,336,32,230,262,248,35,3,146,136,1330
Austin Daye,SF,25,TOT,22,1,148,24,68,12,37,12,31,6,10,5,22,27,8,4,4,5,18,66
Austin Rivers,PG,21,NOP,69,4,1339,192,474,36,99,156,375,110,173,26,103,129,160,45,9,77,134,530
Avery Bradley,SG,23,BOS,60,58,1855,361,825,79,200,282,625,90,112,48,178,226,85,63,11,96,145,891
Ben Gordon,SG,30,CHA,19,0,279,37,108,8,29,29,79,17,21,3,24,27,21,10,2,21,18,99
Ben McLemore,SG,20,SAC,82,55,2187,255,679,95,297,160,382,115,143,53,182,235,82,45,18,96,201,720
Beno Udrih,SG,31,TOT,41,12,643,78,178,19,42,59,136,25,30,10,49,59,116,23,4,47,50,200
Bernard James,C,28,DAL,30,0,146,11,23,0,1,11,22,6,11,15,27,42,3,3,8,10,24,28
Bismack Biyombo,C,21,CHA,77,9,1072,88,144,0,0,88,144,46,89,105,261,366,8,7,86,40,124,222
Blake Griffin,PF,24,LAC,80,80,2863,718,1359,12,44,706,1315,482,674,192,565,757,309,92,51,224,265,1930
Boris Diaw,PF,31,SAS,79,24,1974,302,580,45,112,257,468,68,92,74,252,326,222,44,32,121,140,717
Bradley Beal,SG,20,WAS,73,73,2530,481,1149,138,343,343,806,149,189,54,219,273,243,71,18,128,153,1249
Brandan Wright,C,26,DAL,58,0,1077,224,331,0,0,224,331,77,106,102,142,244,31,32,55,35,94,525
Brandon Bass,PF,28,BOS,82,73,2266,352,725,2,6,350,719,205,239,161,309,470,87,36,71,102,190,911
Brandon Davies,PF,22,PHI,51,0,575,54,128,2,10,52,118,34,53,38,71,109,28,24,8,35,92,144
Brandon Jennings,PG,24,DET,80,79,2728,423,1135,154,457,269,678,241,321,59,185,244,609,101,8,215,157,1241
Brandon Knight,PG,22,MIL,72,69,2400,461,1092,110,338,351,754,259,323,46,209,255,352,69,17,188,146,1291
Brandon Rush,SG,28,UTA,38,0,418,30,90,16,47,14,43,3,5,5,39,44,24,5,9,20,31,79
Brian Roberts,PG,28,NOP,72,42,1667,244,581,64,178,180,403,125,133,17,119,136,234,43,7,95,132,677
Brook Lopez,C,25,BRK,17,17,533,129,229,0,1,129,228,94,115,39,63,102,16,9,30,28,52,352
Byron Mullens,C,24,TOT,45,0,414,73,165,33,89,40,76,10,20,24,68,92,14,15,11,27,64,189
C.J. McCollum,SG,22,POR,38,0,476,74,178,30,80,44,98,23,34,7,41,48,27,14,2,35,53,201
C.J. Miles,SG,26,CLE,51,34,984,178,409,83,211,95,198,64,75,18,85,103,52,46,15,44,103,503
C.J. Watson,PG,29,IND,63,5,1193,146,334,53,145,93,189,69,88,19,82,101,107,60,8,60,66,414
Carl Landry,PF,30,SAC,18,1,233,31,60,0,0,31,60,14,17,15,42,57,5,3,1,9,34,76
Carlos Boozer,PF,32,CHI,76,76,2141,447,980,0,2,447,978,148,193,137,495,632,118,53,22,154,216,1042
Carmelo Anthony,PF,29,NYK,77,77,2982,743,1643,167,415,576,1228,459,541,145,477,622,242,95,51,198,224,2112
Caron Butler,SF,33,TOT,56,13,1419,213,540,98,249,115,291,63,75,21,208,229,82,47,17,60,120,587
Carrick Felix,SG,23,CLE,7,0,38,7,14,2,5,5,9,3,4,1,5,6,4,0,0,4,4,19
Cartier Martin,SF,29,TOT,59,6,870,111,264,59,151,52,113,48,65,13,97,110,33,27,7,34,71,329
Casper Ware,PG,24,PHI,9,0,116,18,42,7,21,11,21,5,6,0,9,9,10,8,0,5,11,48
Chandler Parsons,SF,25,HOU,74,74,2783,466,987,130,351,336,636,164,221,69,340,409,298,88,29,144,168,1226
Channing Frye,PF,30,PHO,82,82,2312,336,778,160,432,176,346,78,95,73,343,416,98,60,63,89,245,910
Charlie Villanueva,PF,29,DET,20,0,180,35,92,14,56,21,36,8,14,6,28,34,6,4,5,7,16,92
Chase Budinger,SF,25,MIN,41,8,751,100,254,42,120,58,134,32,39,19,84,103,31,19,2,24,58,274
Chauncey Billups,SG,37,DET,19,7,309,24,79,14,48,10,31,10,12,4,24,28,42,8,1,25,25,72
Chris Andersen,C,35,MIA,72,0,1396,177,275,3,12,174,263,120,169,129,250,379,19,32,97,53,162,477
Chris Babb,SG,23,BOS,14,0,132,8,30,6,27,2,3,0,0,4,13,17,3,6,0,3,13,22
Chris Bosh,C,29,MIA,79,79,2531,492,953,74,218,418,735,223,272,98,424,522,87,80,78,125,192,1281
Chris Copeland,SF,29,IND,41,0,265,55,117,33,79,22,38,10,14,7,25,32,18,3,7,14,38,153
Chris Douglas-Roberts,SF,27,CHA,49,8,1016,111,252,51,132,60,120,66,82,16,103,119,51,29,16,36,61,339
Chris Johnson,SF,23,BOS,40,0,789,85,214,43,127,42,87,37,43,31,66,97,31,27,4,22,63,250
Chris Kaman,C,31,LAL,39,13,736,176,346,0,3,176,343,52,68,54,175,229,58,11,40,74,93,404
Chris Paul,PG,28,LAC,62,62,2171,406,870,78,212,328,658,295,345,38,230,268,663,154,4,145,157,1185
Chris Singleton,SF,24,WAS,25,0,250,25,67,7,19,18,48,18,25,18,37,55,6,9,3,17,25,75
Chris Smith,PG,26,NYK,2,0,2,0,0,0,0,0,0,0,0,0,0,0,0,0,0,0,0,0
Chris Wright,SF,25,MIL,8,0,126,21,35,0,1,21,34,6,15,10,10,20,5,7,5,5,17,48
Chuck Hayes,C,30,TOT,61,1,754,56,130,0,1,56,129,20,25,69,141,210,35,34,12,33,95,132
Cody Zeller,C,21,CHA,82,3,1416,172,404,0,1,172,403,146,200,118,235,353,92,40,41,87,170,490
Cole Aldrich,C,25,NYK,46,2,330,33,61,0,0,33,61,26,30,37,92,129,14,8,30,18,40,92
Corey Brewer,SF,27,MIN,81,81,2609,388,807,59,211,329,596,163,227,63,144,207,135,151,30,105,210,998
Cory Joseph,SG,22,SAS,68,19,936,126,265,12,38,114,227,79,96,32,75,107,114,35,14,43,84,343
Courtney Lee,SG,28,TOT,79,47,1973,295,614,72,194,223,420,99,112,29,158,187,115,65,28,73,127,761
D.J. Augustin,PG,26,TOT,71,9,1939,298,718,133,332,165,386,201,227,15,115,130,313,53,3,125,147,930
D.J. Stephens,SG,23,MIL,3,0,15,3,7,0,0,3,7,1,1,1,4,5,0,0,0,0,0,7
D.J. White,PF,27,CHA,2,0,10,0,1,0,0,0,1,0,0,0,2,2,0,1,0,0,1,0
Damian Lillard,PG,23,POR,82,82,2937,553,1304,218,554,335,750,371,426,35,253,288,457,64,22,193,197,1695
Damion James,SF,26,SAS,5,1,50,2,9,0,2,2,7,2,2,1,11,12,3,0,1,1,3,6
Daniel Orton,C,23,PHI,22,4,251,21,47,0,0,21,47,23,30,16,45,61,15,6,16,18,38,65
Danny Granger,SF,30,TOT,41,2,847,116,307,43,128,73,179,63,67,31,102,133,41,12,17,46,62,338
Danny Green,SG,26,SAS,68,59,1651,218,505,132,318,86,187,50,63,25,204,229,104,65,61,76,107,618
Dante Cunningham,PF,26,MIN,81,7,1635,236,509,0,5,236,504,38,67,112,218,330,83,62,58,42,146,510
Darius Johnson-Odom,SG,24,PHI,3,0,15,0,7,0,3,0,4,0,2,0,2,2,1,1,0,2,3,0
Darius Miller,SF,23,NOP,45,7,723,73,166,25,77,48,89,29,36,9,43,52,43,24,9,22,88,200
Darius Morris,PG,23,TOT,27,0,313,39,96,12,38,27,58,17,26,7,19,26,44,13,0,27,33,107
Darrell Arthur,SF,25,DEN,68,1,1161,162,410,24,64,138,346,53,62,52,158,210,61,39,47,58,185,401
Darren Collison,PG,26,LAC,80,35,2069,324,694,71,189,253,505,192,224,47,141,188,297,93,15,132,150,911
David Lee,PF,30,GSW,69,67,2288,513,981,0,1,513,980,231,296,182,461,643,147,48,26,152,206,1257
David West,PF,33,IND,80,80,2472,458,939,4,15,454,924,198,251,120,422,542,223,61,74,133,186,1118
DeAndre Jordan,C,25,LAC,82,82,2870,348,515,0,0,348,515,160,374,331,783,1114,74,80,203,123,264,856
DeAndre Liggins,SG,25,MIA,1,0,1,1,1,0,0,1,1,0,0,1,0,1,0,0,0,0,0,2
DeJuan Blair,PF,24,DAL,78,13,1214,210,393,0,2,210,391,77,121,139,229,368,70,60,21,77,192,497
DeMar DeRozan,SG,24,TOR,79,79,3017,604,1407,64,210,540,1197,519,630,51,292,343,313,86,28,176,197,1791
DeMarcus Cousins,C,23,SAC,71,71,2298,591,1191,0,7,591,1184,432,595,218,613,831,207,109,91,251,270,1614
DeMarre Carroll,SF,27,ATL,73,73,2341,302,642,97,268,205,374,109,141,107,296,403,134,108,21,79,188,810
Dennis Schroder,PG,20,ATL,49,0,641,72,188,10,42,62,146,29,43,5,55,60,93,17,0,61,54,183
Derek Fisher,SG,39,OKC,81,0,1428,141,361,88,229,53,132,55,71,12,110,122,117,70,3,49,157,425
Deron Williams,PG,29,BRK,64,58,2059,322,716,98,268,224,448,173,216,15,153,168,392,93,13,143,148,915
Derrick Favors,PF,22,UTA,73,73,2201,390,747,0,1,390,746,190,284,199,438,637,91,75,108,129,236,970
Derrick Rose,PG,25,CHI,10,10,311,58,164,16,47,42,117,27,32,9,23,32,43,5,1,34,15,159
Derrick Williams,SF-PF,22,TOT,78,15,1820,206,482,26,99,180,383,186,259,71,252,323,56,48,20,76,114,624
Devin Harris,PG,30,DAL,40,0,818,96,254,31,101,65,153,92,115,8,77,85,178,28,2,59,72,315
Dewayne Dedmon,C,24,TOT,31,6,390,38,83,0,0,38,83,21,32,38,89,127,5,7,22,18,66,97
Dexter Pittman,C,25,ATL,2,0,3,0,1,0,0,0,1,0,2,3,0,3,0,0,0,0,0,0
Diante Garrett,PG,25,UTA,71,0,1048,101,265,36,96,65,169,10,12,11,86,97,120,41,5,75,75,248
Dion Waiters,SG,22,CLE,70,24,2072,430,993,92,250,338,743,161,235,32,163,195,209,63,17,154,153,1113
Dionte Christmas,SF,27,PHO,31,0,198,22,62,9,31,13,31,18,24,13,25,38,8,2,3,6,19,71
Dirk Nowitzki,PF,35,DAL,80,80,2628,633,1273,131,329,502,944,338,376,40,458,498,216,73,45,117,165,1735
Donald Sloan,SG,26,IND,48,1,392,44,117,10,42,34,75,12,20,4,40,44,50,10,1,22,19,110
Donatas Motiejunas,PF,23,HOU,62,3,952,131,296,21,84,110,212,58,96,60,165,225,34,20,21,49,132,341
Dorell Wright,SF,28,POR,68,13,984,111,297,69,202,42,95,52,69,29,162,191,64,23,16,39,62,343
Doron Lamb,SG,22,ORL,53,0,695,63,160,36,90,27,70,29,36,8,41,49,43,11,1,27,54,191
Draymond Green,SF,23,GSW,82,12,1797,187,459,55,165,132,294,82,123,86,323,409,152,102,72,91,231,511
Drew Gooden,C,32,WAS,22,0,395,76,143,7,17,69,126,24,27,37,77,114,15,10,7,17,53,183
Dwight Buycks,PG,24,TOR,14,0,146,15,48,5,17,10,31,8,9,4,19,23,10,8,0,10,11,43
Dwight Howard,C,28,HOU,71,71,2396,473,800,2,7,471,793,349,638,231,635,866,131,60,128,229,240,1297
Dwyane Wade,SG,32,MIA,54,53,1775,415,761,9,32,406,729,189,258,60,181,241,252,79,29,161,106,1028
E'Twaun Moore,SG,24,ORL,79,3,1506,195,456,57,161,138,295,52,68,29,107,136,112,60,13,55,106,499
Earl Clark,PF,26,TOT,54,17,768,97,261,41,122,56,139,22,34,22,121,143,18,17,25,31,67,257
Earl Watson,PG,34,POR,24,0,161,3,11,2,7,1,4,4,4,5,10,15,28,5,1,17,33,12
Ed Davis,PF,24,MEM,63,4,956,155,290,0,0,155,290,47,89,92,168,260,27,17,43,40,114,357
Ekpe Udoh,PF,26,MIL,42,14,804,57,143,0,0,57,143,30,47,61,87,148,31,15,44,38,96,144
Elias Harris,SF,24,LAL,2,0,11,0,1,0,0,0,1,0,0,1,0,1,1,1,0,0,0,0
Elliot Williams,SG,24,PHI,67,2,1157,140,337,37,125,103,212,87,119,30,100,130,72,35,3,68,126,404
Elton Brand,C,34,ATL,73,15,1414,179,332,0,2,179,330,61,94,97,264,361,74,40,88,60,192,419
Enes Kanter,C,21,UTA,80,37,2138,419,853,0,1,419,852,149,204,222,376,598,75,28,42,144,230,987
Eric Bledsoe,PG,24,PHO,43,40,1416,265,556,50,140,215,416,183,237,27,175,202,235,69,14,143,99,763
Eric Gordon,SG,25,NOP,64,64,2057,356,817,101,258,255,559,175,223,30,135,165,208,74,12,134,114,988
Eric Maynor,PG,26,TOT,31,0,327,32,101,12,37,20,64,6,11,9,30,39,52,9,3,29,17,82
Erik Murphy,C,23,CHI,24,0,62,3,13,0,3,3,10,0,0,2,6,8,2,0,4,2,7,6
Ersan Ilyasova,PF,26,MIL,55,47,1478,237,579,37,131,200,448,107,130,107,235,342,72,46,8,61,135,618
Evan Fournier,SG,21,DEN,76,4,1503,228,544,89,237,139,307,93,123,34,168,202,112,34,7,100,179,638
Evan Turner,SF,25,TOT,81,56,2457,434,1021,50,156,384,865,213,262,62,346,408,262,67,7,189,195,1131
Francisco Garcia,SF,32,HOU,55,4,1083,118,294,69,193,49,101,10,19,21,101,122,63,27,33,30,120,315
Gal Mekel,PG,25,DAL,31,1,292,30,86,5,20,25,66,8,12,5,22,27,63,4,1,31,31,73
Garrett Temple,SG,27,WAS,75,0,638,51,141,6,29,45,112,30,43,21,47,68,72,35,11,42,72,138
Gary Neal,SG,29,TOT,52,3,1114,193,471,68,180,125,291,94,105,10,80,90,83,18,0,64,65,548
George Hill,PG,27,IND,76,76,2434,272,616,95,260,177,356,142,176,53,230,283,265,75,23,92,158,781
Gerald Green,SG,28,PHO,82,48,2330,448,1006,204,510,244,496,195,230,48,227,275,122,70,42,145,220,1295
Gerald Henderson,SG,26,CHA,77,77,2461,403,930,40,115,363,815,235,309,31,279,310,199,51,32,113,159,1081
Gerald Wallace,SF,31,BOS,58,16,1416,116,230,19,64,97,166,47,101,36,176,212,143,73,14,97,79,298
Giannis Antetokounmpo,SF,19,MIL,77,23,1897,173,418,41,118,132,300,138,202,78,261,339,150,60,61,122,173,525
Glen Davis,PF,28,TOT,68,44,1662,271,593,4,11,267,582,95,137,108,243,351,77,58,29,76,159,641
Glen Rice,SG,23,WAS,11,1,109,11,37,5,17,6,20,5,7,4,16,20,7,6,1,9,7,32
Goran Dragic,SG,27,PHO,76,75,2668,552,1093,122,299,430,794,316,416,69,176,245,447,104,22,213,206,1542
Gordon Hayward,SF,23,UTA,77,77,2800,426,1032,85,280,341,752,311,381,62,329,391,400,110,40,212,155,1248
Gorgui Dieng,C,24,MIN,60,15,818,113,227,1,1,112,226,59,93,103,197,300,39,30,50,54,108,286
Greg Monroe,PF,23,DET,82,82,2690,504,1015,0,1,504,1014,241,367,256,504,760,171,91,47,166,205,1249
Greg Oden,C,26,MIA,23,6,212,27,49,0,0,27,49,13,23,23,31,54,1,7,13,12,52,67
Greg Smith,C,23,HOU,11,0,100,18,28,0,0,18,28,2,5,11,16,27,0,1,2,5,17,38
Greg Stiemsma,C,28,NOP,55,20,1007,70,122,0,1,70,121,19,32,72,154,226,36,35,57,44,169,159
Greivis Vasquez,SG-PG,27,TOT,79,23,1779,277,658,109,289,168,369,95,108,20,153,173,323,31,5,128,143,758
Gustavo Ayon,C,28,ATL,26,14,429,52,102,0,0,52,102,8,20,42,83,125,28,25,10,29,47,112
Hamady N'Diaye,C,27,SAC,14,0,74,3,9,0,0,3,9,0,1,5,13,18,3,0,4,3,15,6
Harrison Barnes,SF,21,GSW,78,24,2204,271,679,66,190,205,489,130,181,66,245,311,116,65,20,84,158,738
Hasheem Thabeet,C,26,OKC,23,0,192,13,23,0,0,13,23,1,5,9,31,40,1,4,9,14,47,27
Hedo Turkoglu,SF,34,LAC,38,0,392,42,109,22,50,20,59,9,18,11,78,89,33,19,10,16,50,115
Henry Sims,C,23,TOT,46,25,875,130,274,0,1,130,273,90,121,104,133,237,52,28,20,41,116,350
Hilton Armstrong,C,29,GSW,15,1,97,9,19,0,0,9,19,7,16,19,28,47,5,4,4,6,11,25
Hollis Thompson,SF,22,PHI,77,41,1742,171,372,67,167,104,205,52,73,73,174,247,73,53,12,60,144,461
Ian Clark,SG,22,UTA,23,0,172,26,67,11,31,15,36,5,7,3,16,19,15,8,2,14,24,68
Ian Mahinmi,C,27,IND,77,1,1248,91,189,0,1,91,188,90,145,107,150,257,24,41,72,58,207,272
Iman Shumpert,SG,23,NYK,74,58,1962,183,484,76,228,107,256,53,71,81,227,308,129,92,13,79,209,495
Isaiah Canaan,PG,22,HOU,22,0,252,31,87,18,55,13,32,21,29,7,17,24,22,8,4,21,25,101
Isaiah Thomas,PG,24,SAC,72,54,2497,496,1096,127,364,369,732,346,407,47,163,210,454,93,8,213,185,1465
Ish Smith,PG,25,PHO,70,1,1006,119,281,1,23,118,258,22,39,31,98,129,179,49,13,65,66,261
J.J. Barea,PG,29,MIN,79,1,1471,254,656,73,231,181,425,79,100,16,138,154,303,26,0,125,129,660
J.J. Hickson,PF,25,DEN,69,52,1859,332,654,0,8,332,646,150,290,206,426,632,96,47,51,128,177,814
J.J. Redick,SG,29,LAC,35,34,987,181,398,73,185,108,213,97,106,9,65,74,78,28,3,42,65,532
J.R. Smith,SF,28,NYK,74,37,2421,396,955,189,480,207,475,90,138,35,261,296,219,65,20,108,196,1071
Jae Crowder,SF,23,DAL,78,8,1254,130,296,50,151,80,145,46,61,46,148,194,60,59,21,41,100,356
Jamaal Franklin,SG,22,MEM,21,0,161,16,39,5,11,11,28,2,2,4,19,23,6,4,2,11,23,39
Jamaal Tinsley,PG,35,UTA,8,5,110,4,20,1,15,3,5,0,0,2,9,11,23,2,0,9,10,9
Jamal Crawford,SG,33,LAC,69,24,2094,421,1011,161,446,260,565,279,322,34,124,158,223,59,12,135,120,1282
Jameer Nelson,PG,31,ORL,68,68,2179,294,747,136,391,158,356,96,112,29,202,231,476,52,5,166,146,820
James Anderson,SG,24,PHI,80,62,2309,309,717,115,351,194,366,77,106,59,241,300,149,74,28,106,154,810
James Harden,SG,24,HOU,73,73,2777,549,1205,177,483,372,722,576,665,61,283,344,446,115,29,265,177,1851
James Johnson,SF,26,MEM,52,4,956,143,308,22,87,121,221,76,90,60,106,166,111,42,57,66,102,384
James Jones,SF,33,MIA,20,6,236,31,68,28,54,3,14,7,11,2,21,23,9,3,4,4,6,97
James Nunnally,SF,23,TOT,13,0,165,15,46,8,25,7,21,6,9,1,18,19,8,6,2,7,11,44
James Southerland,SF,23,TOT,4,0,30,5,15,3,6,2,9,1,2,0,8,8,0,1,2,1,3,14
Jan Vesely,PF,23,TOT,54,1,776,89,173,0,0,89,173,19,56,81,110,191,21,53,35,36,121,197
Jannero Pargo,PG,34,CHA,29,0,242,52,118,24,60,28,58,8,11,1,19,20,52,14,1,26,17,136
Jared Cunningham,SG,22,TOT,13,0,80,6,21,1,7,5,14,13,16,1,5,6,8,3,0,2,16,26
Jared Dudley,SF,28,LAC,74,43,1729,196,447,81,225,115,222,38,58,36,124,160,104,41,10,56,146,511
Jared Sullinger,PF,21,BOS,74,44,2041,384,899,56,208,328,691,158,203,241,360,601,118,35,49,119,251,982
Jarrett Jack,PG,30,CLE,80,31,2252,286,698,63,185,223,513,125,149,22,201,223,324,56,22,133,133,760
Jarvis Varnado,PF,25,TOT,24,0,339,36,60,0,0,36,60,27,52,19,44,63,13,10,29,10,62,99
Jason Collins,C,35,BRK,22,1,172,11,24,0,3,11,21,3,4,7,12,19,4,8,1,7,30,25
Jason Maxiell,PF,30,ORL,34,13,488,47,105,0,0,47,105,15,31,28,58,86,9,8,20,14,47,109
Jason Smith,PF,27,NOP,31,27,830,131,282,0,0,131,282,39,50,51,130,181,29,11,29,28,100,301
Jason Terry,PG,36,BRK,35,0,570,55,152,39,103,16,49,10,15,4,33,37,56,13,0,27,48,159
Jason Thompson,PF,27,SAC,82,61,2007,251,496,0,0,251,496,84,145,153,374,527,53,32,56,95,251,586
JaVale McGee,C,26,DEN,5,5,79,17,38,0,0,17,38,1,1,10,7,17,2,1,7,8,16,35
Jeff Adrien,PF,27,TOT,53,12,961,143,275,0,0,143,275,76,119,102,204,306,38,24,36,39,108,362
Jeff Ayres,PF,26,SAS,73,10,952,101,174,0,0,101,174,38,55,89,169,258,60,13,25,63,146,240
Jeff Green,SF,27,BOS,82,82,2805,482,1171,135,396,347,775,283,356,54,326,380,138,57,47,165,180,1382
Jeff Teague,PG,25,ATL,79,79,2542,456,1040,74,225,382,815,318,376,34,174,208,528,89,17,232,158,1304
Jeff Withey,C,23,NOP,58,4,684,69,129,0,1,69,128,52,73,49,101,150,26,15,50,20,73,190
Jeffery Taylor,SF,24,CHA,26,8,629,82,218,18,67,64,151,26,47,15,45,60,22,13,5,25,62,208
Jeremy Evans,SF,26,UTA,66,4,1209,175,332,0,2,175,330,51,75,120,190,310,44,42,46,40,139,401
Jeremy Lamb,SG,21,OKC,78,0,1538,263,609,88,247,175,362,51,64,27,162,189,115,56,26,61,143,665
Jeremy Lin,PG,25,HOU,71,33,2054,295,662,82,229,213,433,218,265,34,153,187,294,68,27,176,166,890
Jeremy Tyler,C,22,NYK,41,0,398,60,116,0,0,60,116,26,48,38,71,109,8,6,20,26,70,146
Jermaine O'Neal,PF,35,GSW,44,13,883,125,248,0,0,125,248,99,132,85,157,242,25,14,40,52,102,349
Jerryd Bayless,PG,25,TOT,72,19,1686,248,617,76,212,172,405,94,118,22,123,145,194,60,9,82,161,666
Jimmer Fredette,SG,24,TOT,49,0,519,107,227,40,84,67,143,19,21,8,44,52,64,14,3,48,35,273
Jimmy Butler,SG,24,CHI,67,67,2591,275,693,68,240,207,453,260,338,87,243,330,175,127,36,102,106,878
Joakim Noah,C,28,CHI,80,80,2820,380,800,0,2,380,798,247,335,282,618,900,431,99,121,194,245,1007
Jodie Meeks,SG,26,LAL,77,70,2556,413,892,162,404,251,488,221,258,30,164,194,138,111,4,111,119,1209
Joe Johnson,SG,32,BRK,79,79,2575,462,1018,162,404,300,614,159,195,48,222,270,216,47,10,120,129,1245
Joel Anthony,C,31,TOT,33,0,186,12,32,0,0,12,32,4,8,15,23,38,2,3,12,3,17,28
Joel Freeland,C,26,POR,52,0,727,77,162,0,2,77,160,20,29,88,120,208,36,10,22,32,95,174
John Henson,PF,23,MIL,70,23,1856,344,639,0,1,344,638,91,177,171,326,497,113,41,116,114,185,779
John Jenkins,SG,22,ATL,13,0,158,16,42,4,18,12,24,4,4,3,19,22,11,1,1,11,11,40
John Lucas III,PG,31,UTA,42,6,591,62,190,25,84,37,106,10,16,12,27,39,42,14,0,22,41,159
John Salmons,SG-SF,34,TOT,78,8,1726,150,413,63,163,87,250,40,52,20,143,163,147,47,19,54,124,403
John Wall,PG,23,WAS,82,82,2980,579,1337,108,308,471,1029,317,394,38,295,333,721,149,40,295,219,1583
Jon Leuer,PF,24,MEM,49,0,642,121,246,23,49,98,197,37,47,37,121,158,20,18,13,27,63,302
Jonas Jerebko,PF,26,DET,64,0,741,98,208,31,74,67,134,43,59,51,124,175,39,21,6,43,85,270
Jonas Valanciunas,C,21,TOR,81,81,2282,359,676,0,1,359,675,198,260,226,488,714,57,24,71,136,249,916
Jordan Crawford,SG-PG,25,TOT,81,35,1859,327,788,90,285,237,503,146,169,28,155,183,281,47,5,134,120,890
Jordan Farmar,PG,27,LAL,41,5,912,151,364,70,160,81,204,44,59,20,84,104,199,38,8,95,65,416
Jordan Hamilton,SF,23,TOT,60,12,1019,147,376,70,198,77,178,40,51,32,162,194,52,44,20,46,67,404
Jordan Hill,PF,26,LAL,72,32,1500,286,521,0,1,286,520,124,181,194,341,535,54,29,64,75,172,696
Jorge Gutierrez,PG,25,BRK,15,2,244,25,54,3,12,22,42,9,12,3,19,22,30,10,1,14,37,62
Jose Calderon,PG,32,DAL,81,81,2468,341,748,191,425,150,323,52,63,29,163,192,377,69,11,103,136,925
Josh Childress,SF,30,NOP,4,0,24,0,0,0,0,0,0,0,0,0,3,3,2,1,0,1,1,0
Josh Harrellson,C,24,DET,32,0,317,38,82,12,31,26,51,5,7,30,46,76,15,6,15,10,44,93
Josh McRoberts,PF,26,CHA,78,78,2360,247,566,105,291,142,275,62,85,85,288,373,333,58,46,83,189,661
Josh Powell,PF,31,HOU,1,0,19,2,6,0,0,2,6,0,0,0,5,5,0,0,1,1,1,4
Josh Smith,SF,28,DET,77,76,2730,517,1233,70,265,447,968,160,301,102,418,520,252,105,110,199,197,1264
Jrue Holiday,PG,23,NOP,34,34,1143,203,454,30,77,173,377,51,63,28,114,142,268,56,12,105,92,487
Julyan Stone,SG,25,TOR,21,0,120,7,17,2,8,5,9,2,3,2,18,20,12,3,0,5,13,18
Justin Hamilton,C,23,TOT,8,0,72,9,20,3,9,6,11,5,5,4,3,7,0,5,0,4,8,26
Kawhi Leonard,SF,22,SAS,66,65,1923,337,645,69,182,268,463,101,126,76,336,412,133,114,50,80,127,844
Keith Bogans,SG,33,BOS,6,0,55,3,6,3,6,0,0,3,3,0,3,3,3,1,0,1,2,12
Kelly Olynyk,C,22,BOS,70,9,1400,234,502,40,114,194,388,99,122,140,225,365,109,35,27,106,227,607
Kemba Walker,PG,23,CHA,73,73,2614,449,1143,109,327,340,816,282,337,39,267,306,447,86,32,169,128,1289
Kendall Marshall,PG,22,LAL,54,45,1564,170,419,71,178,99,241,19,36,15,140,155,477,48,4,150,76,430
Kendrick Perkins,C,29,OKC,62,62,1207,87,193,0,1,87,192,37,67,82,223,305,67,26,32,90,177,211
Kenneth Faried,PF,24,DEN,80,77,2178,447,820,0,3,447,817,202,311,238,446,684,96,70,69,135,193,1096
Kent Bazemore,SG,24,TOT,67,15,911,147,343,43,128,104,215,66,109,10,107,117,91,43,13,79,102,403
Kentavious Caldwell-Pope,SG,20,DET,80,41,1583,182,460,59,185,123,275,47,61,38,118,156,55,75,12,28,145,470
Kenyon Martin,PF,36,NYK,32,15,633,63,123,0,1,63,122,11,19,36,98,134,50,25,27,26,85,137
Kevin Durant,SF,25,OKC,81,81,3122,849,1688,192,491,657,1197,703,805,58,540,598,445,103,59,285,174,2593
Kevin Garnett,C,37,BRK,54,54,1109,157,356,0,3,157,353,38,47,60,298,358,82,43,40,69,123,352
Kevin Love,PF,25,MIN,77,77,2797,650,1421,190,505,460,916,520,633,224,739,963,341,59,35,196,136,2010
Kevin Martin,SG,30,MIN,68,68,2177,440,1023,115,297,325,726,303,340,34,169,203,121,66,6,106,123,1298
Kevin Seraphin,C,24,WAS,53,1,578,111,220,0,0,111,220,27,31,53,75,128,17,3,26,41,103,249
Khris Middleton,SF,22,MIL,82,64,2460,376,854,120,290,256,564,118,137,60,250,310,169,83,20,123,243,990
Kirk Hinrich,PG,33,CHI,73,61,2116,243,619,85,242,158,377,95,125,31,161,192,286,80,26,120,203,666
Klay Thompson,SG,23,GSW,81,81,2868,559,1259,223,535,336,724,147,185,38,211,249,181,74,37,135,234,1488
Kobe Bryant,SG,35,LAL,6,6,177,31,73,3,16,28,57,18,21,2,24,26,38,7,1,34,9,83
Kosta Koufos,C,24,MEM,80,22,1349,227,459,0,0,227,459,60,93,160,258,418,39,32,71,67,182,514
Kris Humphries,PF,28,BOS,69,30,1376,231,461,0,2,231,459,117,144,127,282,409,67,31,61,64,136,579
Kyle Korver,SG,32,ATL,71,71,2408,289,609,185,392,104,217,87,94,22,260,282,208,70,24,102,147,850
Kyle Lowry,PG,27,TOR,79,79,2862,457,1080,190,500,267,580,313,385,88,281,369,586,121,15,194,267,1417
Kyle O'Quinn,C,23,ORL,69,19,1188,186,371,0,3,186,368,57,83,100,264,364,78,39,88,78,165,429
Kyle Singler,SF,25,DET,82,36,2337,269,602,94,246,175,356,152,184,116,187,303,75,61,38,79,211,784
Kyrie Irving,PG,21,CLE,71,71,2496,532,1237,123,344,409,893,291,338,52,207,259,433,108,23,190,163,1478
LaMarcus Aldridge,PF,28,POR,69,69,2498,652,1423,3,15,649,1408,296,360,166,599,765,178,63,68,123,147,1603
Lance Stephenson,SG,23,IND,78,78,2752,427,870,86,244,341,626,140,197,95,463,558,359,54,7,210,195,1080
Lance Thomas,SF,25,NOP,5,0,42,2,9,0,0,2,9,2,4,2,5,7,3,0,0,2,4,6
Landry Fields,SF,25,TOR,30,2,322,27,67,0,5,27,62,14,22,15,44,59,20,10,3,11,25,68
Larry Sanders,C,25,MIL,23,20,584,76,162,0,1,76,161,26,55,60,105,165,19,18,40,26,74,178
Lavoy Allen,PF,24,TOT,65,2,1072,134,300,2,13,132,287,33,50,119,192,311,71,24,33,44,126,303
Leandro Barbosa,PG,31,PHO,20,0,368,56,131,7,25,49,106,31,39,5,32,37,32,7,4,19,30,150
LeBron James,PF,29,MIA,77,77,2902,767,1353,116,306,651,1047,439,585,81,452,533,488,121,26,270,126,2089
Lorenzo Brown,PG,23,PHI,26,0,224,26,86,3,30,23,56,9,13,8,20,28,41,13,3,16,19,64
Lou Amundson,PF,31,TOT,19,0,185,16,32,0,0,16,32,6,24,28,27,55,6,9,11,14,49,38
Lou Williams,PG,27,ATL,60,7,1445,197,493,79,231,118,262,152,179,10,114,124,210,45,4,92,65,625
Luc Mbah a Moute,PF-SF,27,TOT,64,7,1003,87,193,4,17,83,176,46,67,56,90,146,36,30,14,40,68,224
Luigi Datome,SF,26,DET,34,0,238,34,97,7,39,27,58,8,10,14,32,46,11,6,1,11,20,83
Luis Scola,PF,33,IND,82,2,1399,263,560,1,7,262,553,99,136,86,305,391,81,26,16,108,164,626
Luke Babbitt,PF,24,NOP,27,2,473,60,154,36,95,24,59,14,18,18,70,88,29,7,11,15,52,170
Luke Ridnour,PG,32,TOT,61,14,1141,126,327,37,108,89,219,17,26,23,74,97,176,32,8,66,92,306
Luol Deng,SF,28,TOT,63,63,2213,371,860,57,189,314,671,212,268,99,262,361,183,62,9,114,111,1011
Maalik Wayns,PG,22,LAC,2,0,9,1,2,0,0,1,2,0,0,0,2,2,2,2,0,0,4,2
Malcolm Thomas,PF,25,TOT,8,0,63,7,16,1,4,6,12,0,2,5,16,21,2,0,3,9,5,15
Manny Harris,SG,24,LAL,9,0,180,28,70,7,20,21,50,10,12,7,27,34,11,4,1,9,10,73
Manu Ginobili,SG,36,SAS,68,3,1550,294,627,90,258,204,369,160,188,30,172,202,293,70,17,139,128,838
Marc Gasol,C,29,MEM,59,59,1970,336,711,2,11,334,700,185,241,84,340,424,215,59,76,111,150,859
Marcin Gortat,C,29,WAS,81,80,2655,455,840,1,1,454,839,157,229,202,565,767,138,41,121,126,201,1068
Marco Belinelli,SF,27,SAS,80,25,2016,337,695,126,293,211,402,111,131,18,208,226,179,50,7,95,130,911
Marcus Morris,SF,24,PHO,82,1,1800,288,651,99,260,189,391,121,159,84,235,319,88,72,18,95,157,796
Marcus Thornton,SG,26,TOT,72,27,1741,252,639,109,316,143,323,90,112,57,141,198,77,58,11,67,110,703
Mario Chalmers,PG,27,MIA,73,73,2178,254,560,87,226,167,334,121,163,41,173,214,357,119,16,162,210,716
Markieff Morris,PF,24,PHO,81,0,2153,411,845,34,108,377,737,259,327,139,346,485,144,68,51,147,232,1115
Marquis Teague,SG,20,TOT,40,3,443,38,119,5,18,33,101,26,35,1,39,40,58,10,5,39,46,107
Marreese Speights,C,26,GSW,79,3,982,195,442,8,31,187,411,110,134,101,189,290,32,10,34,66,148,508
MarShon Brooks,SG,25,TOT,35,0,316,57,125,13,25,44,100,32,44,10,44,54,25,14,4,24,21,159
Martell Webster,SF,27,WAS,78,13,2157,254,587,146,372,108,215,105,125,38,184,222,97,41,15,58,150,759
Marvin Williams,PF,27,UTA,66,50,1674,231,526,84,234,147,292,57,73,82,252,334,78,54,31,53,151,603
Mason Plumlee,C,23,BRK,70,22,1275,199,302,0,3,199,299,122,195,99,209,308,60,49,55,77,171,520
Matt Barnes,SF,33,LAC,63,40,1735,231,527,97,283,134,244,66,90,60,232,292,125,56,28,85,185,625
Matt Bonner,PF,33,SAS,61,0,690,73,164,42,98,31,66,9,12,16,114,130,31,15,11,16,49,197
Matthew Dellavedova,SG,23,CLE,72,4,1271,122,296,57,155,65,141,38,48,29,94,123,187,33,5,60,121,339
Maurice Harkless,SF,20,ORL,80,41,1950,224,483,59,154,165,329,85,143,69,195,264,80,97,50,86,140,592
Melvin Ely,C,35,NOP,2,0,27,3,6,0,0,3,6,0,0,0,1,1,0,0,1,0,5,6
Metta World Peace,SF,34,NYK,29,1,388,56,141,17,54,39,87,10,16,18,41,59,17,24,8,19,44,139
Meyers Leonard,C,21,POR,40,0,355,41,91,0,6,41,85,16,21,26,85,111,18,7,5,15,76,98
Michael Beasley,SF,25,MIA,55,2,831,177,355,21,54,156,301,61,79,31,141,172,42,23,21,57,93,436
Michael Carter-Williams,PG,22,PHI,70,70,2414,427,1054,55,208,372,846,258,367,101,336,437,441,130,43,247,213,1167
Michael Kidd-Gilchrist,SF,20,CHA,62,62,1502,167,353,1,9,166,344,113,184,109,215,324,52,43,39,60,145,448
Mike Conley,PG,26,MEM,73,73,2446,463,1030,105,291,358,739,225,276,41,172,213,441,110,13,150,141,1256
Mike Dunleavy,SF,33,CHI,82,61,2584,333,774,123,324,210,450,140,164,46,299,345,186,64,46,108,163,929
Mike Harris,PF,30,UTA,20,0,225,29,61,0,2,29,59,26,27,15,18,33,5,16,7,11,36,84
Mike James,PG,38,CHI,11,0,77,5,21,1,5,4,16,0,2,0,7,7,17,2,0,5,11,11
Mike Miller,SF,33,MEM,82,4,1707,213,443,107,233,106,210,46,56,30,177,207,130,26,5,77,95,579
Mike Muscala,PF,22,ATL,20,0,215,31,73,0,3,31,70,14,14,17,35,52,7,3,10,12,29,76
Mike Scott,PF,25,ATL,80,6,1482,301,628,62,200,239,428,103,132,62,222,284,75,30,7,79,121,767
Miles Plumlee,C,25,PHO,80,79,1964,286,553,0,0,286,553,74,132,198,428,626,43,50,90,111,185,646
Miroslav Raduljica,C,26,MIL,48,2,465,68,126,0,0,68,126,45,55,54,54,108,23,7,13,28,84,181
Mirza Teletovic,SF,28,BRK,72,7,1396,221,529,136,349,85,180,44,62,60,206,266,57,29,23,54,143,622
Mo Williams,PG,31,POR,74,0,1834,280,672,83,225,197,447,78,89,42,111,153,321,55,10,149,197,721
Monta Ellis,SG,28,DAL,82,82,3023,576,1278,69,209,507,1069,339,430,38,257,295,471,141,23,264,197,1560
Mustafa Shakur,PG,29,OKC,3,0,11,0,3,0,1,0,2,1,2,0,0,0,4,0,0,2,2,1
Nando De Colo,SF,26,TOT,47,3,494,64,153,18,53,46,100,31,35,14,59,73,65,22,6,35,48,177
Nate Robinson,PG,29,DEN,44,1,866,164,383,58,154,106,229,71,85,21,60,81,112,36,4,58,92,457
Nate Wolters,PG,22,MIL,58,31,1309,170,389,18,62,152,327,59,90,33,116,149,187,35,15,57,67,417
Nazr Mohammed,C,36,CHI,80,1,562,54,126,0,0,54,126,16,30,66,109,175,20,14,30,37,77,124
Nemanja Nedovic,SG,22,GSW,24,0,142,8,39,3,18,5,21,7,8,3,12,15,13,0,1,13,13,26
Nene Hilario,PF,31,WAS,53,37,1560,299,594,1,5,298,589,155,266,65,229,294,153,64,47,117,164,754
Nick Calathes,SG,24,MEM,71,7,1173,142,311,19,61,123,250,44,72,23,114,137,207,66,8,101,117,347
Nick Collison,PF,33,OKC,81,0,1353,134,241,4,17,130,224,66,93,116,177,293,104,30,28,71,187,338
Nick Young,SG,28,LAL,64,9,1810,387,889,135,350,252,539,235,285,29,137,166,95,46,12,95,156,1144
Nicolas Batum,SF,25,POR,82,82,2956,381,819,145,402,236,417,163,203,116,495,611,420,75,57,208,156,1070
Nikola Pekovic,C,28,MIN,54,54,1663,379,701,0,0,379,701,186,249,206,262,468,50,30,23,84,129,944
Nikola Vucevic,C,23,ORL,57,57,1812,353,696,0,0,353,696,105,137,185,441,626,104,60,47,112,169,811
Norris Cole,PG,25,MIA,82,6,2014,207,500,60,174,147,326,53,68,17,143,160,248,77,5,127,156,527
O.J. Mayo,SG,26,MIL,52,23,1346,224,550,84,227,140,323,76,88,24,100,124,113,28,13,95,111,608
Ognjen Kuzmic,C,23,GSW,21,0,92,5,13,0,0,5,13,5,11,10,11,21,2,3,4,10,17,15
Omer Asik,C,27,HOU,48,19,968,101,190,0,0,101,190,78,126,101,277,378,25,14,37,59,92,280
Omri Casspi,PF,25,HOU,71,2,1283,173,410,61,176,112,234,83,122,55,205,260,88,44,14,72,100,490
Orlando Johnson,SG,24,TOT,45,0,392,36,113,9,47,27,66,19,26,9,46,55,20,6,2,15,26,100
Othyus Jeffers,SG,28,TOT,6,1,47,3,6,0,2,3,4,3,4,1,8,9,1,0,0,1,3,9
Otto Porter,SF,20,WAS,37,0,319,33,91,4,21,29,70,8,12,21,36,57,10,8,1,14,26,78
P.J. Tucker,SF,28,PHO,81,81,2490,265,615,74,191,191,424,156,201,161,368,529,141,110,23,102,204,760
Pablo Prigioni,PG,36,NYK,66,27,1283,88,191,65,140,23,51,11,12,36,93,129,228,67,2,60,132,252
Patrick Beverley,PG,25,HOU,56,55,1751,199,481,92,255,107,226,83,102,72,124,196,151,77,23,66,174,573
Patrick Patterson,PF,24,TOT,65,13,1533,225,489,55,151,170,338,50,71,117,225,342,78,55,37,65,159,555
Patty Mills,PG,25,SAS,81,2,1527,309,666,135,318,174,348,73,82,34,135,169,149,68,9,63,114,826
Pau Gasol,C,33,LAL,60,60,1884,425,885,4,14,421,871,187,254,124,456,580,201,27,92,141,124,1041
Paul George,SF,23,IND,80,80,2898,577,1362,182,500,395,862,401,464,64,478,542,283,151,22,224,198,1737
Paul Millsap,PF,28,ATL,74,73,2482,483,1047,76,212,407,835,286,391,154,473,627,232,129,78,185,210,1328
Paul Pierce,SF,36,BRK,75,68,2098,321,712,112,300,209,412,256,310,26,322,348,178,86,31,153,190,1010
Pero Antic,C,31,ATL,50,26,925,123,294,56,171,67,123,50,66,57,152,209,58,19,12,55,126,352
Perry Jones,PF,22,OKC,62,7,764,83,181,22,61,61,120,28,42,28,86,114,26,14,19,21,62,216
Peyton Siva,SG,23,DET,24,0,224,18,57,7,25,11,32,11,15,2,12,14,34,9,1,18,27,54
Phil Pressey,PG,22,BOS,75,11,1132,78,253,28,106,50,147,29,45,20,85,105,241,68,5,87,97,213
Quincy Acy,SF,23,TOT,63,0,847,66,141,4,15,62,126,35,53,72,144,216,28,23,26,30,122,171
Quincy Miller,PF,21,DEN,52,16,789,94,256,30,94,64,162,39,55,36,111,147,26,22,32,48,70,257
Quincy Pondexter,SG,25,MEM,15,2,270,31,79,11,34,20,45,21,26,10,16,26,20,5,1,15,18,94
Rajon Rondo,PG,27,BOS,30,30,998,141,350,26,90,115,260,42,67,22,142,164,294,40,2,99,65,350
Ramon Sessions,PG,27,TOT,83,19,2214,330,769,35,124,295,645,326,404,38,165,203,340,49,9,148,90,1021
Randy Foye,SG,30,DEN,81,78,2485,361,875,189,498,172,377,157,185,36,196,232,287,67,39,145,205,1068
Rashard Lewis,SF,34,MIA,60,6,971,98,236,46,134,52,102,26,33,24,86,110,57,53,8,35,90,268
Rasual Butler,SG,34,IND,50,2,378,51,110,26,62,25,48,8,14,6,35,41,17,7,9,11,30,136
Ray Allen,SG,38,MIA,73,9,1936,240,543,116,309,124,234,105,116,23,182,205,143,54,8,84,115,701
Ray McCallum,PG,22,SAC,45,10,897,113,300,22,59,91,241,32,43,18,61,79,120,22,9,39,69,280
Raymond Felton,PG,29,NYK,65,65,2017,240,608,62,195,178,413,88,122,54,143,197,365,78,27,129,157,630
Reggie Bullock,SF,22,LAC,43,0,395,43,121,22,73,21,48,7,9,11,43,54,12,9,1,13,26,115
Reggie Evans,PF,33,TOT,54,20,899,71,150,0,0,71,150,72,130,115,219,334,21,37,3,58,119,214
Reggie Jackson,PG,23,OKC,80,36,2277,403,916,83,245,320,671,158,177,43,270,313,331,85,9,168,142,1047
Reggie Williams,SF,27,OKC,3,0,17,5,9,1,3,4,6,0,0,0,0,0,1,1,0,2,1,11
Richard Jefferson,SF,33,UTA,82,78,2213,294,654,123,301,171,353,120,162,18,201,219,130,56,14,94,168,831
Ricky Ledo,SG,21,DAL,11,0,33,6,17,3,8,3,9,4,4,0,2,2,2,1,0,2,2,19
Ricky Rubio,PG,23,MIN,82,82,2638,255,670,44,133,211,537,227,283,61,281,342,704,191,11,221,218,781
Robbie Hummel,SF,24,MIN,53,5,655,67,177,32,89,35,88,15,16,35,97,132,23,16,2,10,57,181
Robert Covington,SF,23,HOU,7,0,34,6,14,4,11,2,3,0,0,2,3,5,0,2,0,1,3,16
Robert Sacre,C,24,LAL,65,13,1089,143,300,0,0,143,300,64,94,82,172,254,51,24,47,44,134,350
Robin Lopez,C,25,POR,82,82,2603,355,644,0,1,355,643,198,242,326,374,700,73,25,139,84,196,908
Rodney Stuckey,SG,27,DET,73,5,1950,372,853,24,88,348,765,244,292,39,130,169,152,54,10,125,131,1012
Roger Mason,SG,33,MIA,25,2,260,25,67,17,48,8,19,7,7,1,21,22,19,6,1,9,26,74
Ronnie Brewer,SF,28,TOT,24,3,160,3,15,1,8,2,7,0,2,2,12,14,10,6,1,2,4,7
Ronnie Price,SG,30,ORL,31,2,377,28,92,9,43,19,49,9,13,8,35,43,66,25,2,26,50,74
Ronny Turiaf,C,31,MIN,31,10,606,64,107,0,0,64,107,21,50,55,119,174,24,8,50,24,65,149
Roy Hibbert,C,27,IND,81,81,2409,331,754,2,5,329,749,207,269,202,336,538,91,29,182,148,269,871
Royal Ivey,SG,32,OKC,2,0,5,0,2,0,1,0,1,0,0,0,1,1,0,0,0,0,1,0
Royce White,PF,22,SAC,3,0,9,0,1,0,0,0,1,0,0,0,0,0,0,0,0,0,2,0
Rudy Gay,SF,27,TOT,73,73,2531,537,1179,65,197,472,982,318,387,113,324,437,209,95,56,224,171,1457
Rudy Gobert,C,21,UTA,45,0,434,36,74,0,0,36,74,32,65,51,104,155,7,8,41,32,57,104
Russell Westbrook,PG,25,OKC,46,46,1412,346,791,68,214,278,577,242,293,55,208,263,319,88,7,177,104,1002
Ryan Anderson,PF,25,NOP,22,14,795,155,354,67,164,88,190,59,62,66,76,142,17,10,7,20,47,436
Ryan Gomes,SF,31,OKC,5,0,34,3,8,0,2,3,6,0,0,0,4,4,1,0,0,1,5,6
Ryan Hollins,PF,29,LAC,61,0,482,53,72,0,0,53,72,35,56,31,59,90,8,9,31,29,87,141
Ryan Kelly,PF,22,LAL,59,25,1312,157,371,48,142,109,229,110,135,42,177,219,95,32,45,47,147,472
Samuel Dalembert,C,32,DAL,80,68,1614,214,377,0,1,214,376,101,137,200,341,541,38,41,94,90,210,529
Sasha Vujacic,SG,29,LAC,2,0,10,2,5,1,2,1,3,0,0,0,3,3,0,1,0,3,1,5
Scotty Hopson,SG,24,CLE,2,0,7,0,4,0,2,0,2,1,2,0,0,0,1,1,0,0,0,1
Serge Ibaka,PF,24,OKC,81,81,2666,524,978,23,60,501,918,156,199,224,485,709,85,39,219,123,233,1227
Sergey Karasev,SF,20,CLE,22,1,156,12,35,4,19,8,16,9,10,0,16,16,6,3,1,11,22,37
Seth Curry,PG,23,TOT,2,0,13,1,3,1,1,0,2,0,0,0,1,1,0,2,0,0,0,3
Shabazz Muhammad,SG,21,MIN,37,0,290,57,124,3,11,54,113,26,40,24,29,53,6,8,1,16,24,143
Shane Battier,SF,35,MIA,73,56,1468,105,275,73,210,32,65,15,23,34,104,138,63,50,39,21,124,298
Shane Edwards,SF,26,CLE,2,0,12,1,3,0,0,1,3,0,0,1,1,2,0,0,0,1,1,2
Shane Larkin,PG,21,DAL,48,0,489,52,137,12,38,40,99,16,25,11,31,42,71,26,1,39,46,132
Shannon Brown,SG,28,TOT,29,1,251,24,66,0,2,24,64,15,21,7,21,28,9,13,0,18,24,63
Shaun Livingston,PG,28,BRK,76,54,1974,235,487,1,6,234,481,158,191,67,179,246,245,93,31,105,172,629
Shavlik Randolph,PF,30,PHO,14,0,95,7,14,0,0,7,14,6,11,7,18,25,1,3,1,5,15,20
Shawn Marion,SF,35,DAL,76,76,2409,341,708,58,162,283,546,51,65,132,365,497,124,90,37,95,125,791
Shawne Williams,PF,27,LAL,36,13,751,73,192,42,129,31,63,14,20,25,142,167,30,19,30,21,93,202
Shelvin Mack,PG,23,ATL,73,11,1490,209,501,62,184,147,317,64,74,21,139,160,271,50,2,89,100,544
Solomon Hill,SF,22,IND,28,0,226,17,40,7,23,10,17,6,7,9,32,41,12,5,2,13,19,47
Solomon Jones,PF,29,ORL,11,0,85,6,17,0,0,6,17,2,4,8,8,16,2,2,2,2,12,14
Spencer Hawes,C,25,TOT,80,78,2470,403,883,128,308,275,575,119,152,131,529,660,240,44,94,173,237,1053
Stephen Curry,PG,25,GSW,78,78,2846,652,1383,261,615,391,768,308,348,46,288,334,666,128,14,294,194,1873
Stephen Jackson,SF,35,LAC,9,0,107,6,26,1,14,5,12,2,4,2,8,10,5,6,1,6,11,15
Steve Blake,PG,33,TOT,55,28,1498,133,353,79,210,54,143,33,43,13,146,159,307,54,8,102,85,378
Steve Nash,PG,39,LAL,15,10,313,36,94,8,24,28,70,22,24,4,25,29,86,7,2,31,18,102
Steve Novak,PF,30,TOR,54,1,540,60,146,52,122,8,24,6,6,8,50,58,13,12,4,5,44,178
Steven Adams,C,20,OKC,81,20,1197,93,185,0,0,93,185,79,136,142,190,332,43,40,57,71,203,265
Taj Gibson,PF,28,CHI,82,8,2351,429,896,0,7,429,889,211,281,200,358,558,91,41,112,150,207,1069
Tayshaun Prince,SF,33,MEM,76,76,1948,200,492,20,69,180,423,34,60,32,202,234,119,39,19,41,63,454
Terrence Jones,PF,22,HOU,76,71,2078,386,712,31,101,355,611,118,195,162,366,528,87,53,99,71,139,921
Terrence Ross,SG,22,TOR,81,62,2159,318,751,161,408,157,343,82,98,43,209,252,79,64,27,88,183,879
Thabo Sefolosha,SG,29,OKC,61,61,1584,141,340,48,152,93,188,53,69,50,170,220,94,79,17,55,90,383
Thaddeus Young,PF,25,PHI,79,78,2718,582,1283,90,292,492,991,163,229,166,310,476,182,167,36,165,213,1417
Thomas Robinson,PF,22,POR,70,0,873,141,293,0,1,141,292,57,101,105,202,307,34,23,20,57,131,339
Tiago Splitter,C,29,SAS,59,50,1271,181,346,0,3,181,343,121,173,123,240,363,90,29,31,75,117,483
Tim Duncan,C,37,SAS,74,74,2158,444,906,0,5,444,901,231,316,158,563,721,220,43,139,159,134,1119
Tim Hardaway,SG,21,NYK,81,1,1875,294,687,130,358,164,329,106,128,19,102,121,66,44,7,47,144,824
Timofey Mozgov,C,27,DEN,82,30,1770,285,545,4,24,281,521,196,260,171,357,528,62,27,100,122,213,770
Tobias Harris,PF,21,ORL,61,36,1850,332,716,32,126,300,590,197,244,88,336,424,82,41,24,78,143,893
Toney Douglas,PG,27,TOT,51,17,675,73,190,31,102,42,88,25,34,18,69,87,68,19,5,34,81,202
Tony Allen,SG,32,MEM,55,28,1278,204,413,11,47,193,366,76,121,79,129,208,94,90,19,90,121,495
Tony Parker,PG,31,SAS,68,68,1997,456,914,25,67,431,847,197,243,17,138,155,388,36,9,151,86,1134
Tony Snell,SG,22,CHI,77,12,1231,129,336,57,178,72,158,31,41,19,105,124,68,29,15,44,84,346
Tony Wroten,PG,20,PHI,72,16,1765,345,808,40,188,305,620,209,326,69,159,228,217,78,16,204,151,939
Tornike Shengelia,SF,22,TOT,26,0,154,13,28,0,6,13,22,3,8,4,12,16,14,3,1,12,18,29
Toure' Murry,PG,24,NYK,51,0,373,56,129,5,12,51,117,23,39,13,31,44,49,19,1,34,46,140
Travis Outlaw,SF,29,SAC,63,4,1065,130,326,41,117,89,209,42,52,36,132,168,48,20,19,26,94,343
Trevor Ariza,SF,28,WAS,77,77,2723,389,853,180,442,209,411,149,193,99,376,475,191,126,20,132,179,1107
Trevor Booker,PF,26,WAS,72,45,1553,222,403,0,2,222,401,47,76,149,230,379,64,41,45,58,131,491
Trey Burke,PG,21,UTA,70,68,2262,341,897,111,336,230,561,102,113,37,171,208,396,42,6,131,145,895
Tristan Thompson,PF,22,CLE,82,82,2594,363,761,0,1,363,760,235,339,269,485,754,72,42,35,108,188,961
Troy Daniels,SG,22,HOU,5,1,75,15,31,12,25,3,6,0,0,0,4,4,5,0,0,3,6,42
Ty Lawson,PG,26,DEN,62,61,2222,347,806,72,202,275,604,324,406,40,175,215,543,100,10,200,113,1090
Tyler Hansbrough,PF,28,TOR,64,4,978,93,196,0,2,93,194,126,185,120,167,287,17,28,19,47,132,312
Tyler Zeller,C,24,CLE,70,9,1049,156,290,0,1,156,289,87,121,103,179,282,36,18,38,60,137,399
Tyreke Evans,SF,24,NOP,72,22,2028,391,897,21,95,370,802,239,310,76,265,341,363,84,21,175,155,1042
Tyshawn Taylor,PG,23,BRK,23,3,270,31,91,3,12,28,79,24,30,3,12,15,36,12,1,31,29,89
Tyson Chandler,C,31,NYK,55,55,1662,191,322,0,1,191,321,98,155,159,370,529,59,36,63,71,145,480
Udonis Haslem,PF,33,MIA,46,18,653,74,146,0,0,74,146,25,44,42,133,175,13,11,15,24,79,173
Vander Blue,SG,21,BOS,3,0,15,2,4,0,1,2,3,1,5,0,3,3,1,0,0,2,1,5
Viacheslav Kravtsov,C,26,PHO,20,0,59,8,15,0,0,8,15,4,8,9,8,17,1,0,1,6,7,20
Victor Claver,SF,25,POR,21,0,184,17,42,3,18,14,24,10,11,9,30,39,12,3,3,11,16,47
Victor Oladipo,PG,21,ORL,80,44,2487,392,936,74,226,318,710,248,318,43,286,329,327,129,37,256,210,1106
Vince Carter,SG,37,DAL,81,0,1973,330,811,146,371,184,440,161,196,67,217,284,212,61,35,108,209,967
Vitor Faverani,C,25,BOS,37,8,488,64,147,12,40,52,107,24,37,42,86,128,16,14,27,41,74,164
Wayne Ellington,SG,26,DAL,45,1,393,55,126,25,59,30,67,10,11,8,35,43,19,16,2,11,33,145
Wesley Johnson,SF,26,LAL,79,62,2240,277,651,100,271,177,380,61,77,70,278,348,124,86,77,90,207,715
Wesley Matthews,SG,27,POR,82,82,2780,445,1009,201,511,244,498,252,301,51,238,289,197,76,14,110,176,1343
Will Barton,SG,23,POR,41,0,387,65,156,10,33,55,123,26,32,16,58,74,33,9,7,18,31,166
Will Bynum,PG,31,DET,56,3,1054,184,430,20,62,164,368,97,121,24,75,99,216,39,7,103,121,485
Willie Green,SG,32,LAC,55,9,869,102,271,41,121,61,150,28,34,12,66,78,50,22,11,34,96,273
Wilson Chandler,SF,26,DEN,62,55,1927,307,738,122,351,185,387,110,152,58,236,294,114,46,31,79,193,846
Xavier Henry,SF,22,LAL,43,5,908,144,345,28,81,116,264,116,177,25,89,114,51,44,7,57,79,432
Zach Randolph,PF,32,MEM,79,79,2705,560,1198,2,20,558,1178,250,337,265,530,795,200,54,23,183,210,1372
Zaza Pachulia,C,29,MIL,53,43,1325,149,349,0,1,149,348,110,130,141,192,333,136,45,14,92,124,408