Player,Pos,Age,Tm,G,GS,MP,FG,FGA,3P,3PA,2P,2PA,FT,FTA,ORB,DRB,TRB,AST,STL,BLK,TOV,PF,PTS
Aaron Brooks,PG,33,MIN,32,1,189,28,69,11,31,17,38,8,11,7,10,17,20,6,0,11,28,75
Aaron Gordon,PF,22,ORL,58,57,1909,375,865,115,342,260,523,157,225,87,370,457,136,59,45,107,111,1022
Aaron Harrison,SG,23,DAL,9,3,233,19,69,9,43,10,26,13,17,4,20,24,11,9,2,3,27,60
Aaron Jackson,PG,31,HOU,1,0,35,3,9,1,4,2,5,1,2,2,1,3,1,0,0,1,4,8
Abdel Nader,SF,24,BOS,48,1,522,50,149,23,65,27,84,23,39,13,58,71,26,15,10,34,45,146
Adreian Payne,PF,26,ORL,5,0,43,7,10,2,3,5,7,5,6,2,7,9,0,2,0,2,6,21
Al Horford,C,31,BOS,72,72,2277,368,753,97,226,271,527,94,120,103,427,530,339,43,78,132,138,927
Al Jefferson,C,33,IND,36,1,484,111,208,0,3,111,205,30,36,30,113,143,30,16,23,21,66,252
Al-Farouq Aminu,PF,27,POR,69,67,2072,230,582,125,339,105,243,59,80,97,428,525,84,79,40,79,136,644
Alan Williams,PF,25,PHO,5,0,70,7,18,0,0,7,18,6,9,3,19,22,8,5,1,7,13,20
Alec Burks,SG,26,UTA,64,1,1059,170,414,47,142,123,272,107,124,19,173,192,67,37,8,60,75,494
Alec Peters,PF,22,PHO,20,0,225,28,74,18,58,10,16,8,10,8,29,37,12,2,2,4,13,82
Alex Abrines,SG,24,OKC,75,8,1134,115,291,84,221,31,70,39,46,26,88,114,28,38,8,25,124,353
Alex Caruso,PG,23,LAL,37,7,562,50,116,13,43,37,73,21,30,15,50,65,75,23,10,42,52,134
Alex Len,C,24,PHO,69,13,1395,214,378,1,3,213,375,158,231,175,343,518,82,27,61,78,158,587
Alex Poythress,PF,24,IND,25,0,104,11,26,4,11,7,15,0,0,7,10,17,2,3,1,2,16,26
Alfonzo McKinnie,SF,25,TOR,14,0,53,8,15,3,9,5,6,2,3,1,6,7,1,1,1,3,8,21
Allen Crabbe,SG,25,BRK,75,68,2197,337,827,201,532,136,295,115,135,28,296,324,117,47,35,78,168,990
Amir Johnson,C,30,PHI,74,18,1171,140,260,10,32,130,228,52,85,123,207,330,118,45,44,55,193,342
Andre Drummond,C,24,DET,78,78,2625,466,881,0,11,466,870,239,395,399,848,1247,237,114,127,200,250,1171
Andre Iguodala,SF,34,GSW,64,7,1622,148,320,33,117,115,203,55,87,50,196,246,210,54,38,67,99,384
Andre Ingram,SG,32,LAL,2,0,64,8,17,5,9,3,8,3,3,1,5,6,7,3,3,3,3,24
Andre Roberson,SG,26,OKC,39,39,1037,87,162,8,36,79,126,12,38,75,110,185,46,45,35,30,89,194
Andrew Bogut,C,33,LAL,23,5,216,17,25,0,0,17,25,2,2,26,52,78,15,4,13,19,40,36
Andrew Harrison,PG,23,MEM,56,46,1326,181,429,47,142,134,287,124,159,23,108,131,177,38,26,81,138,533
Andrew White,SF,24,ATL,15,0,209,25,73,18,49,7,24,1,4,4,30,34,6,3,1,8,12,69
Andrew Wiggins,SF,22,MIN,82,82,2979,569,1300,112,338,457,962,202,314,82,276,358,160,91,51,138,163,1452
Ante Zizic,C,21,CLE,32,2,214,49,67,0,0,49,67,21,29,24,36,60,5,2,13,11,30,119
Anthony Brown,SF,25,MIN,1,0,4,1,1,1,1,0,0,0,0,0,0,0,1,0,0,0,0,3
Anthony Davis,PF,24,NOP,75,75,2727,780,1462,55,162,725,1300,495,598,187,645,832,174,115,193,162,159,2110
Anthony Tolliver,PF,32,DET,79,14,1757,219,472,159,365,60,107,106,133,50,191,241,90,32,21,58,144,703
Antonio Blakeney,SG,21,CHI,19,0,314,53,143,15,52,38,91,30,39,4,29,33,20,7,1,11,19,151
Antonius Cleveland,SG,23,TOT,17,0,123,8,21,3,4,5,17,4,6,3,11,14,2,7,5,7,23,23
Aron Baynes,C,31,BOS,81,67,1485,210,446,3,21,207,425,59,78,129,304,433,93,22,51,80,200,482
Arron Afflalo,SG,32,ORL,53,3,682,65,162,27,70,38,92,22,26,4,62,66,30,4,9,21,56,179
Austin Rivers,SG,25,LAC,61,59,2057,341,805,136,360,205,445,102,159,27,118,145,242,74,16,109,152,920
Avery Bradley,SG,27,TOT,46,46,1433,259,625,75,203,184,422,63,82,22,94,116,94,51,8,101,92,656
Bam Adebayo,C,20,MIA,69,19,1368,174,340,0,7,174,333,129,179,118,263,381,101,32,41,66,138,477
Ben McLemore,SG,24,MEM,56,17,1091,157,373,55,159,102,214,53,64,34,105,139,51,38,15,61,139,422
Ben Moore,PF,22,IND,2,0,9,0,0,0,0,0,0,0,0,0,1,1,1,0,0,0,4,0
Ben Simmons,PG,21,PHI,81,81,2732,544,998,0,11,544,987,191,341,145,514,659,661,140,70,278,211,1279
Bismack Biyombo,C,25,ORL,82,25,1495,183,352,0,1,183,351,102,157,144,324,468,66,21,95,84,158,468
Blake Griffin,PF,28,TOT,58,58,1970,436,996,111,322,325,674,259,330,73,355,428,334,41,18,165,139,1242
Boban Marjanovic,C,29,TOT,39,1,337,79,148,0,0,79,148,77,97,48,96,144,22,10,11,36,51,235
Bobby Brown,PG,33,HOU,20,0,115,19,58,11,40,8,18,1,2,0,7,7,11,4,0,9,6,50
Bobby Portis,PF,22,CHI,73,4,1643,382,811,80,223,302,588,120,156,159,339,498,123,50,23,103,130,964
Bogdan Bogdanovic,SG,25,SAC,78,53,2175,344,772,129,329,215,443,100,119,31,192,223,258,72,16,125,172,917
Bojan Bogdanovic,SF,28,IND,80,80,2464,404,852,155,386,249,466,178,205,30,240,270,119,55,8,106,129,1141
Bradley Beal,SG,24,WAS,82,82,2977,683,1484,199,530,484,954,292,368,61,302,363,373,97,36,214,160,1857
Brandan Wright,PF,30,TOT,28,1,381,59,102,0,0,59,102,21,33,33,62,95,13,13,26,8,32,139
Brandon Ingram,SF,20,LAL,59,59,1975,358,761,41,105,317,656,192,282,57,257,314,230,45,43,149,163,949
Brandon Jennings,PG,28,MIL,14,0,205,27,72,9,33,18,39,10,10,5,26,31,44,6,4,18,11,73
Brandon Paul,SG,26,SAS,64,2,576,55,127,15,54,40,73,22,43,6,62,68,37,25,7,29,58,147
Briante Weber,PG,25,TOT,18,0,237,19,43,4,11,15,32,8,10,8,27,35,22,18,5,15,28,50
Brice Johnson,PF,23,TOT,18,0,98,20,42,0,1,20,41,3,5,9,22,31,2,9,6,5,13,43
Brook Lopez,C,29,LAL,74,72,1735,369,793,112,325,257,468,111,158,74,220,294,126,30,98,98,197,961
Bruno Caboclo,SF,22,TOT,12,0,107,9,31,3,17,6,14,5,6,7,15,22,5,3,4,4,8,26
Bryn Forbes,SG,24,SAS,80,12,1517,209,497,89,228,120,269,48,72,12,98,110,80,28,2,37,108,555
Buddy Hield,SG,24,SAC,80,12,2024,416,933,176,408,240,525,71,81,55,252,307,155,85,22,124,148,1079
C.J. McCollum,SG,26,POR,81,81,2923,667,1505,189,476,478,1029,209,250,53,268,321,272,77,35,151,168,1732
C.J. Miles,SF,30,TOR,70,3,1337,227,599,164,454,63,145,81,97,18,134,152,55,37,21,39,134,699
C.J. Williams,SG,27,LAC,38,17,707,87,197,22,78,65,119,13,16,12,44,56,43,31,13,20,63,209
Caleb Swanigan,PF,20,POR,27,3,189,24,60,1,8,23,52,12,18,15,39,54,14,5,3,18,37,61
Cameron Payne,PG,23,CHI,25,14,582,87,215,35,91,52,124,12,16,18,51,69,113,26,9,36,44,221
Caris LeVert,SF,23,BRK,71,10,1864,320,735,85,245,235,490,133,187,53,207,260,300,82,22,153,159,858
Carmelo Anthony,PF,33,OKC,78,78,2501,472,1168,169,474,303,694,148,193,67,386,453,103,47,49,99,197,1261
Cedi Osman,SF,22,CLE,61,12,672,90,186,32,87,58,99,26,46,19,101,120,41,22,3,32,78,238
Chandler Parsons,SF,29,MEM,36,8,691,108,234,51,121,57,113,17,27,14,76,90,69,18,11,35,53,284
Channing Frye,C,34,TOT,53,1,695,104,212,39,115,65,97,17,19,12,123,135,38,18,13,21,69,264
Charles Cooke,SG,23,NOP,13,0,38,2,14,1,8,1,6,1,2,0,2,2,1,1,0,1,0,6
Cheick Diallo,PF,21,NOP,52,0,581,102,176,0,0,102,176,50,66,47,164,211,19,11,21,28,82,254
Chinanu Onuaku,C,21,HOU,1,0,22,2,5,0,0,2,5,0,0,1,3,4,1,0,0,3,4,4
Chris Boucher,PF,25,GSW,1,0,1,0,1,0,1,0,0,0,0,0,1,1,0,0,0,0,0,0
Chris McCullough,PF,22,WAS,19,0,90,18,42,1,8,17,34,9,14,7,18,25,4,0,5,2,8,46
Chris Paul,PG,32,HOU,58,58,1847,367,798,144,379,223,419,203,221,37,276,313,457,96,14,128,141,1081
Clint Capela,C,23,HOU,74,74,2034,441,676,0,1,441,675,144,257,241,561,802,68,58,137,103,185,1026
Cody Zeller,C,25,CHO,33,0,627,85,156,2,3,83,153,61,85,67,110,177,31,14,21,33,81,233
Cole Aldrich,C,29,MIN,21,0,49,5,15,0,0,5,15,2,6,3,12,15,3,2,1,1,11,12
Corey Brewer,SF-SG,31,TOT,72,18,1208,142,316,31,110,111,206,65,90,43,111,154,65,79,14,49,139,380
Cory Joseph,PG,26,IND,82,17,2210,256,604,67,190,189,414,70,94,39,225,264,260,79,18,87,141,649
Courtney Lee,SG,32,NYK,76,69,2310,343,755,113,278,230,477,114,124,30,194,224,180,80,17,84,109,913
Cristiano Felicio,C,25,CHI,55,16,977,127,215,0,2,127,213,54,81,83,150,233,55,16,11,54,104,308
D.J. Augustin,PG,30,ORL,75,36,1760,244,540,114,272,130,268,164,189,30,130,160,287,54,0,123,94,766
D.J. Wilson,PF,21,MIL,22,0,71,9,16,2,5,7,11,1,2,2,8,10,3,3,1,4,7,21
D'Angelo Russell,PG,21,BRK,48,35,1234,278,672,90,278,188,394,97,131,30,159,189,249,36,17,147,93,743
Dakari Johnson,C,22,OKC,31,6,161,22,39,0,0,22,39,11,20,16,18,34,8,6,8,3,27,55
Damian Jones,C,22,GSW,15,0,89,11,22,0,0,11,22,3,5,5,9,14,2,1,3,4,14,25
Damian Lillard,PG,27,POR,73,73,2670,621,1415,227,629,394,786,493,538,62,263,325,481,77,27,206,117,1962
Damien Wilkins,SF,38,IND,19,1,152,13,39,4,18,9,21,3,4,5,11,16,9,2,1,5,7,33
Damion Lee,SG,25,ATL,15,11,404,62,152,15,60,47,92,22,29,11,60,71,29,19,1,14,25,161
Damyean Dotson,SG,23,NYK,44,2,474,72,161,22,68,50,93,16,23,9,75,84,31,12,2,17,34,182
Daniel Hamilton,SG,22,OKC,6,0,28,5,11,2,5,3,6,0,0,0,5,5,8,1,0,2,2,12
Daniel Theis,C,25,BOS,63,3,936,126,233,18,58,108,175,61,81,90,184,274,56,30,48,56,157,331
Danilo Gallinari,SF,29,LAC,21,21,671,102,256,36,111,66,145,81,87,9,92,101,41,12,10,26,30,321
Danny Green,SG,30,SAS,70,60,1791,217,561,116,320,101,241,50,65,41,208,249,110,63,80,74,122,600
Dante Cunningham,SF,30,TOT,73,25,1562,164,364,58,168,106,196,31,52,78,220,298,48,39,30,33,111,417
Dante Exum,PG,22,UTA,14,0,235,42,87,5,18,37,69,25,31,4,22,26,43,8,3,20,20,114
Danuel House,SG,24,PHO,23,3,403,56,129,15,58,41,71,25,31,13,63,76,25,7,6,11,23,152
Dario Saric,PF,23,PHI,78,73,2310,403,890,157,399,246,491,178,207,154,366,520,202,51,20,148,160,1141
Darius Miller,SF,27,NOP,82,3,1944,216,487,147,358,69,129,58,67,18,146,164,111,28,17,58,160,637
Darrell Arthur,PF,29,DEN,19,1,141,22,47,8,23,14,24,2,3,3,12,15,9,8,3,15,22,54
Darren Collison,PG,30,IND,69,64,2018,316,638,96,205,220,433,127,144,37,141,178,368,92,15,86,121,855
Darrun Hilliard,SG,24,SAS,14,0,95,5,19,0,6,5,13,6,7,0,7,7,11,2,0,4,7,16
David Nwaba,SG,25,CHI,70,21,1646,202,423,18,52,184,371,133,203,89,237,326,104,59,29,77,158,555
David Stockton,PG,26,UTA,3,0,9,2,3,2,3,0,0,4,4,0,0,0,0,0,0,1,3,10
David West,C,37,GSW,73,0,999,216,378,3,8,213,370,60,79,64,174,238,138,47,75,80,120,495
Davis Bertans,PF,25,SAS,77,10,1086,161,366,94,252,67,114,40,49,18,135,153,74,26,28,36,93,456
Davon Reed,SG,22,PHO,21,1,242,22,76,11,38,11,38,8,12,2,37,39,13,10,2,10,17,63
De'Aaron Fox,PG,20,SAC,73,60,2026,328,797,47,153,281,644,141,195,33,171,204,320,70,20,173,163,844
DeAndre Jordan,C,29,LAC,77,77,2424,373,578,0,0,373,578,181,312,329,842,1171,117,39,71,137,203,927
DeAndre Liggins,SG,29,TOT,58,4,724,40,106,19,53,21,53,2,5,7,68,75,48,37,14,20,81,101
DeAndre' Bembry,SF,23,ATL,26,3,455,53,128,11,30,42,98,19,33,8,64,72,49,21,12,47,38,136
Dejounte Murray,PG,21,SAS,81,48,1743,270,609,9,34,261,575,105,148,110,349,459,231,97,31,134,151,654
Delon Wright,PG,25,TOR,69,4,1433,201,432,56,153,145,279,97,117,45,153,198,200,72,33,78,81,555
DeMar DeRozan,SG,28,TOR,80,80,2711,645,1413,89,285,556,1128,461,559,59,256,315,417,85,22,175,151,1840
DeMarcus Cousins,C,27,NOP,48,48,1737,406,864,104,294,302,570,294,394,105,512,617,257,79,76,242,183,1210
DeMarre Carroll,SF,31,BRK,73,73,2180,325,785,145,391,180,394,188,246,105,374,479,147,59,30,103,165,983
Demetrius Jackson,PG,23,TOT,15,0,80,7,18,1,7,6,11,1,2,5,7,12,9,5,1,10,7,16
Dennis Schroder,PG,24,ATL,67,67,2078,500,1146,76,262,424,884,225,265,44,164,208,417,72,6,183,147,1301
Dennis Smith,PG,20,DAL,69,69,2049,404,1023,106,339,298,684,134,193,50,210,260,358,71,18,195,152,1048
Denzel Valentine,SG,24,CHI,77,37,2095,301,721,143,370,158,351,38,51,48,345,393,244,65,11,99,185,783
Derrick Favors,C,26,UTA,77,77,2153,395,702,14,63,381,639,140,215,198,354,552,102,54,82,88,164,944
Derrick Jones,SF,20,TOT,20,8,245,21,53,3,18,18,35,16,24,21,17,38,9,4,13,7,24,61
Derrick Rose,PG,29,TOT,25,7,420,81,186,7,30,74,156,40,46,13,22,35,37,7,4,35,16,209
Derrick Walton,PG,22,MIA,16,0,147,8,25,7,17,1,8,6,6,2,14,16,16,7,3,2,7,29
Derrick White,PG,23,SAS,17,0,139,16,33,8,13,8,20,14,20,5,21,26,9,4,3,6,8,54
Derrick Williams,PF,26,LAL,2,0,9,1,4,0,2,1,2,0,0,0,1,1,0,0,0,0,0,2
Devin Booker,SG,21,PHO,54,54,1865,455,1054,147,384,308,670,289,329,26,218,244,253,47,14,194,168,1346
Devin Harris,PG,34,TOT,71,1,1340,187,454,79,227,108,227,142,170,12,115,127,152,47,12,76,158,595
Devin Robinson,SF,22,WAS,1,0,13,1,3,0,0,1,3,0,0,2,3,5,0,1,0,0,2,2
Dewayne Dedmon,C,28,ATL,62,46,1542,250,477,50,141,200,336,67,86,100,389,489,90,40,51,86,162,617
Deyonta Davis,C,21,MEM,62,6,943,161,265,0,0,161,265,38,57,75,175,250,40,15,39,32,125,360
Dillon Brooks,SF,22,MEM,82,74,2350,340,772,94,264,246,508,124,166,49,208,257,135,73,17,124,233,898
Dion Waiters,SG,26,MIA,30,30,918,163,410,52,170,111,240,51,69,8,69,77,113,23,9,70,61,429
Dirk Nowitzki,C,39,DAL,77,77,1900,346,758,138,337,208,421,97,108,22,416,438,120,43,45,51,146,927
Domantas Sabonis,C,21,IND,74,19,1810,340,661,13,37,327,624,168,224,165,407,572,151,40,32,137,220,861
Donovan Mitchell,SG,21,UTA,79,71,2638,595,1362,187,550,408,812,239,297,52,244,296,291,118,27,215,213,1616
Dorian Finney-Smith,PF,24,DAL,21,13,448,46,121,20,67,26,54,11,15,22,53,75,26,10,4,21,43,123
Doug McDermott,SF,26,TOT,81,4,1768,237,508,92,216,145,292,64,81,40,160,200,79,19,16,56,122,630
Dragan Bender,PF,20,PHO,82,37,2069,187,484,118,322,69,162,39,51,40,321,361,130,22,53,112,166,531
Draymond Green,PF,27,GSW,70,70,2287,281,619,77,256,204,363,134,173,75,460,535,508,95,91,202,185,773
Dwayne Bacon,SG,22,CHO,53,6,713,72,192,11,43,61,149,20,25,4,120,124,38,16,2,23,46,175
Dwight Buycks,PG,28,DET,29,0,427,82,198,15,45,67,153,36,41,12,29,41,59,19,2,39,39,215
Dwight Howard,C,32,CHO,81,81,2463,506,911,1,7,505,904,334,582,255,757,1012,105,48,131,208,251,1347
Dwight Powell,C,26,DAL,79,25,1672,255,430,28,84,227,346,133,185,135,309,444,91,67,32,59,186,671
Dwyane Wade,SG,36,TOT,67,3,1536,299,682,32,111,267,571,135,189,50,202,252,228,61,47,140,124,765
E'Twaun Moore,SG,28,NOP,82,80,2586,423,832,128,301,295,531,48,68,57,181,238,187,79,12,102,182,1022
Ed Davis,C,28,POR,78,0,1471,170,292,0,1,170,291,74,111,183,392,575,40,32,52,66,188,414
Edmond Sumner,PG,22,IND,1,0,2,1,1,0,0,1,1,0,0,0,1,1,0,0,0,0,1,2
Ekpe Udoh,C,30,UTA,63,3,810,60,120,0,1,60,119,42,56,68,82,150,53,43,74,20,105,162
Elfrid Payton,PG,23,TOT,63,63,1808,329,667,30,92,299,575,109,168,64,210,274,393,83,22,168,147,797
Emeka Okafor,C,35,NOP,26,19,353,48,95,0,0,48,95,18,22,47,73,120,8,8,25,13,30,114
Emmanuel Mudiay,PG,21,TOT,64,14,1245,204,526,47,148,157,378,98,129,26,126,152,206,41,11,113,80,553
Enes Kanter,C,25,NYK,71,71,1830,422,713,0,2,422,711,156,184,273,507,780,105,36,37,122,187,1000
Eric Bledsoe,PG,28,TOT,74,74,2322,468,989,125,360,343,629,252,318,51,233,284,370,149,42,216,185,1313
Eric Gordon,SG,29,HOU,69,30,2154,415,970,218,608,197,362,195,241,25,145,170,154,44,27,130,116,1243
Eric Moreland,PF,26,DET,67,3,805,66,122,0,0,66,122,11,29,81,197,278,78,31,51,42,116,143
Erik McCree,SF,24,UTA,4,0,8,0,2,0,1,0,1,0,0,0,1,1,0,1,0,1,0,0
Ersan Ilyasova,PF,30,TOT,69,43,1729,277,613,91,253,186,360,105,135,118,287,405,90,61,26,72,157,750
Evan Fournier,SF,25,ORL,57,57,1837,368,802,127,335,241,467,150,173,23,157,180,165,47,16,95,138,1013
Evan Turner,SF,29,POR,79,40,2034,258,577,42,132,216,445,91,107,30,214,244,173,47,29,99,163,649
Frank Kaminsky,PF,24,CHO,79,4,1835,307,716,104,274,203,442,155,194,46,242,288,129,36,19,66,95,873
Frank Mason,PG,23,SAC,52,2,984,144,380,31,86,113,294,94,115,30,100,130,147,34,10,65,72,413
Frank Ntilikina,PG,19,NYK,78,9,1706,182,500,50,157,132,343,49,68,37,140,177,250,66,18,131,181,463
Fred VanVleet,PG,23,TOR,76,0,1520,232,545,108,261,124,284,84,101,25,159,184,243,68,19,74,130,656
Furkan Korkmaz,SG,20,PHI,14,0,80,8,28,5,17,3,11,2,4,2,9,11,4,2,1,2,12,23
Garrett Temple,SG,31,SAC,65,35,1615,199,476,89,227,110,249,60,78,22,130,152,124,57,27,79,135,547
Gary Harris,SG,23,DEN,67,65,2304,440,908,156,394,284,514,134,162,37,139,176,194,122,15,119,119,1170
Gary Payton,PG,25,TOT,23,6,221,30,74,6,25,24,49,3,9,13,31,44,21,7,3,7,30,69
George Hill,PG,31,TOT,67,60,1812,236,513,85,205,151,308,110,140,42,139,181,186,61,27,88,128,667
Georges Niang,PF,24,UTA,9,0,32,4,11,0,4,4,7,1,2,3,6,9,3,2,0,3,1,9
Georgios Papagiannis,C,20,TOT,17,0,122,18,42,0,0,18,42,0,0,13,24,37,9,4,6,8,12,36
Gerald Green,SG,32,HOU,41,2,929,168,413,110,298,58,115,51,60,15,118,133,25,24,15,31,87,497
Gian Clavell,SG,24,DAL,7,0,64,6,18,6,15,0,3,2,2,1,6,7,3,2,0,2,8,20
Giannis Antetokounmpo,PF,23,MIL,75,75,2756,742,1402,43,140,699,1262,487,641,156,597,753,361,109,106,223,231,2014
Glenn Robinson,SF,24,IND,23,1,338,36,85,14,34,22,51,9,11,11,26,37,17,13,1,5,14,95
Goran Dragic,PG,31,MIA,75,75,2378,484,1075,111,300,373,775,217,271,54,253,307,359,63,12,166,180,1296
Gordon Hayward,SF,27,BOS,1,1,5,1,2,0,1,1,1,0,0,0,1,1,0,0,0,0,1,2
Gorgui Dieng,C,28,MIN,79,0,1333,186,388,19,61,167,327,79,102,106,254,360,71,45,39,59,147,470
Greg Monroe,C,27,TOT,51,14,1040,218,386,0,0,218,386,88,119,109,241,350,114,44,23,94,95,524
Guerschon Yabusele,PF,22,BOS,33,4,235,26,61,12,37,14,24,15,22,17,35,52,16,4,5,12,23,79
Harrison Barnes,PF,25,DAL,77,77,2634,537,1208,119,333,418,875,259,313,77,391,468,152,49,14,118,94,1452
Hassan Whiteside,C,28,MIA,54,54,1364,312,578,2,2,310,576,128,182,174,444,618,54,37,94,92,131,754
Henry Ellenson,PF,21,DET,38,0,329,53,146,20,60,33,86,25,29,10,71,81,20,5,0,18,22,151
Ian Clark,SG,26,NOP,74,2,1455,222,495,62,195,160,300,45,59,10,117,127,110,33,10,57,120,551
Ian Mahinmi,C,31,WAS,77,0,1145,138,248,0,2,138,246,90,128,135,177,312,53,38,42,100,230,366
Ike Anigbogu,C,19,IND,11,0,30,4,9,0,0,4,9,5,6,5,4,9,0,1,3,2,1,13
Iman Shumpert,SG,27,CLE,14,6,276,22,58,7,26,15,32,11,15,7,34,41,17,9,4,16,22,62
Isaiah Canaan,PG-SG,26,TOT,20,1,422,52,137,22,66,30,71,46,51,6,39,45,76,16,1,29,36,172
Isaiah Hicks,PF,23,NYK,18,0,240,33,72,2,9,31,63,12,18,10,31,41,16,2,4,16,45,80
Isaiah Taylor,PG,23,ATL,67,9,1167,163,390,20,80,143,310,99,141,22,72,94,206,34,10,84,116,445
Isaiah Thomas,PG,28,TOT,32,15,862,157,421,55,188,102,233,117,131,17,50,67,153,15,3,95,58,486
Isaiah Whitehead,PG,22,BRK,16,0,180,40,86,7,18,33,68,13,19,4,22,26,20,8,2,24,23,100
Ish Smith,PG,29,DET,82,35,2043,389,801,35,101,354,700,81,116,27,197,224,360,64,20,108,140,894
Ivan Rabb,PF,20,MEM,36,5,516,86,152,0,0,86,152,29,36,53,105,158,32,12,13,35,55,201
Ivica Zubac,C,20,LAL,43,0,410,61,122,0,1,61,121,39,51,45,77,122,25,8,15,26,47,161
J.J. Barea,PG,33,DAL,69,10,1603,303,690,115,313,188,377,80,102,15,186,201,434,35,3,143,83,801
J.J. Redick,SG,33,PHI,70,70,2116,404,879,193,460,211,419,197,218,9,169,178,210,35,6,103,123,1198
J.R. Smith,SG,32,CLE,80,61,2244,240,595,143,381,97,214,39,56,29,206,235,141,68,11,81,161,662
Jabari Bird,SG,23,BOS,13,1,115,15,26,3,7,12,19,6,13,6,13,19,8,3,1,8,7,39
Jabari Parker,PF,22,MIL,31,3,743,160,332,31,81,129,251,40,54,42,109,151,59,25,10,45,50,391
Jack Cooley,PF,26,SAC,7,0,87,13,27,0,0,13,27,14,19,14,16,30,6,1,0,3,13,40
Jacob Pullen,PG,28,PHI,3,0,6,1,2,0,1,1,1,0,0,0,0,0,0,0,0,1,0,2
Jacob Wiley,PF,23,BRK,5,0,33,1,4,1,2,0,2,1,2,2,9,11,2,1,0,0,4,4
Jae Crowder,SF,27,TOT,80,47,2090,271,671,110,341,161,330,121,148,59,216,275,99,64,21,74,187,773
Jahlil Okafor,C,22,TOT,28,0,353,77,138,1,4,76,134,21,29,21,64,85,12,3,18,21,51,176
JaKarr Sampson,SF,24,SAC,22,6,344,44,81,5,10,39,71,10,16,21,57,78,9,8,22,8,48,103
Jake Layman,SF,23,POR,35,1,160,14,47,4,20,10,27,2,3,4,12,16,11,6,4,5,13,34
Jakob Poeltl,C,22,TOR,82,0,1524,253,384,1,2,252,382,60,101,165,228,393,57,39,100,85,212,567
Jalen Jones,SF,24,TOT,16,0,181,26,68,10,26,16,42,12,19,13,25,38,4,5,1,7,22,74
Jamal Crawford,SG,37,MIN,80,0,1653,308,742,104,314,204,428,102,113,21,78,99,185,40,9,95,85,822
Jamal Murray,PG,20,DEN,81,80,2565,479,1062,165,436,314,626,229,253,82,215,297,274,79,28,172,173,1352
Jameel Warney,PF,24,DAL,3,0,27,7,12,0,0,7,12,3,5,4,5,9,0,0,0,1,2,17
Jameer Nelson,PG,35,TOT,50,0,1013,95,244,41,124,54,120,16,20,13,91,104,179,27,4,67,81,247
Jamel Artis,SG,25,ORL,15,1,279,31,79,8,29,23,50,7,12,4,34,38,18,2,3,8,11,77
James Ennis,SF,27,TOT,72,22,1604,182,384,51,153,131,231,97,116,73,151,224,71,47,18,56,134,512
James Harden,SG,28,HOU,72,72,2551,651,1449,265,722,386,727,624,727,41,348,389,630,126,50,315,169,2191
James Johnson,PF,30,MIA,73,41,1943,309,614,57,185,252,429,113,162,61,297,358,280,70,51,142,192,788
James Michael McAdoo,PF,25,PHI,3,0,18,2,7,2,7,0,0,2,2,0,2,2,0,0,1,1,1,8
James Webb,SF,24,BRK,10,0,120,6,24,4,19,2,5,0,0,8,16,24,4,1,0,4,10,16
James Young,SG,22,PHI,6,0,61,5,14,3,10,2,4,4,6,0,2,2,2,0,0,1,4,17
Jamil Wilson,SF,27,LAC,15,10,274,38,81,27,63,11,18,2,4,3,29,32,10,5,8,8,34,105
JaMychal Green,PF,27,MEM,55,54,1542,223,488,43,127,180,361,80,111,147,317,464,79,32,25,76,153,569
Jared Dudley,PF,32,PHO,48,0,686,48,122,29,80,19,42,27,35,8,86,94,78,24,11,28,85,152
Jarell Eddie,SF,26,TOT,3,0,9,0,2,0,2,0,0,0,0,0,1,1,0,1,0,0,0,0
Jarell Martin,PF,23,MEM,73,36,1661,221,496,34,98,187,398,89,116,97,221,318,73,39,49,86,211,565
Jarrett Allen,C,19,BRK,72,31,1441,234,397,5,15,229,382,114,147,144,244,388,49,28,88,82,147,587
Jarrett Jack,PG,34,NYK,62,56,1548,189,443,25,86,164,357,63,75,22,169,191,348,35,4,115,98,466
Jason Smith,C,31,WAS,33,2,285,45,115,4,32,41,83,19,21,18,35,53,14,3,13,16,44,113
Jason Terry,SG,40,MIL,51,4,814,59,154,40,115,19,39,8,9,5,43,48,59,42,13,25,52,166
JaVale McGee,C,30,GSW,65,17,615,136,219,0,6,136,213,38,52,59,110,169,33,21,57,27,91,310
Jawun Evans,PG,21,LAC,48,4,778,89,253,15,54,74,199,38,49,9,75,84,100,36,6,44,97,231
Jaylen Brown,SG,21,BOS,70,70,2152,373,803,121,306,252,497,150,233,67,280,347,114,70,26,124,181,1017
Jaylen Morris,SG,22,ATL,6,0,98,13,31,2,9,11,22,0,0,2,14,16,7,2,1,6,2,28
Jayson Tatum,SF,19,BOS,80,80,2438,397,835,105,242,292,593,213,258,50,352,402,128,83,58,114,170,1112
Jeff Green,PF,31,CLE,78,13,1828,295,618,53,170,242,448,203,234,60,186,246,99,41,34,75,149,846
Jeff Teague,PG,29,MIN,70,70,2311,354,794,84,228,270,566,202,239,24,185,209,492,102,22,177,171,994
Jeff Withey,C,27,DAL,9,0,39,6,16,2,10,4,6,1,2,1,9,10,0,0,3,2,3,15
Jerami Grant,PF,23,OKC,81,1,1647,244,456,32,110,212,346,162,240,86,233,319,57,31,77,54,156,682
Jeremy Evans,SF,30,ATL,1,0,5,1,1,0,0,1,1,0,0,1,0,1,0,0,0,1,1,2
Jeremy Lamb,SG,25,CHO,80,18,1967,380,832,94,254,286,578,179,208,49,275,324,186,61,32,93,138,1033
Jeremy Lin,PG,29,BRK,1,1,25,5,12,1,2,4,10,7,7,0,0,0,4,0,0,3,3,18
Jerian Grant,PG,25,CHI,74,26,1686,209,504,61,188,148,316,140,188,31,141,172,342,63,8,89,132,619
Jerryd Bayless,SG,29,PHI,39,11,925,109,262,54,146,55,116,35,44,15,65,80,54,23,6,46,91,307
Jimmy Butler,SG,28,MIN,59,59,2164,437,921,70,200,367,721,363,425,79,235,314,288,116,24,108,78,1307
Joakim Noah,C,32,NYK,7,0,40,5,10,0,0,5,10,2,4,6,8,14,4,2,2,4,5,12
Jodie Meeks,SG,30,WAS,77,0,1119,157,393,72,210,85,183,101,117,15,111,126,70,29,4,37,55,487
Joe Harris,SG,26,BRK,78,14,1975,305,621,150,358,155,263,86,104,51,209,260,128,35,20,91,153,846
Joe Ingles,SF,30,UTA,82,81,2578,335,718,204,464,131,254,66,83,24,320,344,392,90,20,159,178,940
Joe Johnson,SF,36,TOT,55,4,1205,146,360,40,145,106,215,40,45,14,158,172,83,18,7,49,67,372
Joe Young,PG,25,IND,53,1,558,80,186,25,66,55,120,22,29,12,51,63,39,14,1,26,39,207
Joel Bolomboy,PF,24,MIL,6,0,38,3,6,0,1,3,5,3,6,6,4,10,0,2,0,2,3,9
Joel Embiid,C,23,PHI,63,63,1912,510,1056,66,214,444,842,359,467,143,547,690,199,40,111,234,209,1445
Joffrey Lauvergne,C,26,SAS,55,1,534,98,190,0,5,98,185,30,47,63,108,171,41,9,3,33,45,226
John Collins,PF,20,ATL,74,26,1785,314,545,16,47,298,498,133,186,176,365,541,98,47,80,105,215,777
John Henson,C,27,MIL,76,69,1970,287,502,1,7,286,495,90,158,150,363,513,114,45,109,84,202,665
John Holland,SF,29,CLE,24,0,174,17,59,11,36,6,23,9,13,6,18,24,5,7,2,8,10,54
John Wall,PG,27,WAS,41,41,1410,280,667,62,167,218,500,175,241,22,128,150,393,57,45,158,80,797
Johnathan Motley,PF,22,DAL,11,4,176,40,75,1,6,39,69,15,28,14,35,49,7,3,2,9,18,96
Johnny O'Bryant,PF,24,CHO,36,0,379,68,171,14,43,54,128,21,25,29,64,93,14,9,6,15,45,171
Jon Leuer,PF,28,DET,8,0,136,15,36,0,3,15,33,13,15,7,25,32,5,1,3,7,16,43
Jonas Jerebko,PF,30,UTA,74,19,1134,159,341,65,157,94,184,46,57,53,193,246,42,24,12,27,127,429
Jonas Valanciunas,C,25,TOR,77,77,1727,390,687,30,74,360,613,170,211,183,477,660,81,29,69,115,192,980
Jonathan Gibson,PG,30,BOS,4,0,40,14,23,6,12,8,11,0,0,0,3,3,4,0,0,3,5,34
Jonathan Isaac,PF,20,ORL,27,10,536,55,145,16,46,39,99,19,25,16,83,99,18,33,30,27,48,145
Jonathon Simmons,SG,28,ORL,69,50,2029,354,761,69,204,285,557,185,241,61,178,239,171,58,16,146,175,962
Jordan Bell,C,23,GSW,57,13,809,116,185,0,4,116,181,30,44,60,147,207,102,35,56,51,92,262
Jordan Clarkson,SG,25,TOT,81,2,1888,430,954,112,318,318,636,152,190,57,160,217,221,58,6,127,107,1124
Jordan Crawford,SG,29,NOP,5,0,53,12,27,8,14,4,13,1,1,2,2,4,13,1,1,5,7,33
Jordan Mickey,PF,23,MIA,23,3,284,39,82,2,16,37,66,13,19,18,64,82,9,6,10,18,36,93
Jose Calderon,PG,36,CLE,57,32,914,93,185,45,97,48,88,24,30,14,70,84,117,27,2,41,81,255
Josh Gray,PG,24,PHO,5,0,86,11,41,3,13,8,28,7,11,2,8,10,12,8,2,7,8,32
Josh Hart,SG,22,LAL,63,23,1461,176,375,78,197,98,178,66,94,42,221,263,80,47,16,47,107,496
Josh Huestis,PF,26,OKC,69,10,982,60,182,33,115,27,67,6,20,42,119,161,20,15,43,26,82,159
Josh Jackson,SF,20,PHO,77,35,1959,389,932,57,217,332,715,177,279,95,256,351,119,80,35,146,218,1012
Josh Magette,PG,28,ATL,18,0,216,15,46,8,22,7,24,8,8,2,17,19,57,8,1,9,16,46
Josh McRoberts,PF,30,DAL,2,0,6,0,1,0,1,0,0,0,0,0,0,0,0,0,0,0,2,0
Josh Richardson,SF,24,MIA,81,81,2689,399,885,127,336,272,549,120,142,69,216,285,231,121,75,140,199,1045
Josh Smith,PF,32,NOP,3,0,12,1,4,0,0,1,4,0,0,3,1,4,0,0,0,0,3,2
Jrue Holiday,SG,27,NOP,81,81,2927,615,1244,120,356,495,888,187,238,62,303,365,486,123,64,213,201,1537
Juan Hernangomez,PF,22,DEN,25,3,277,29,75,14,50,15,25,10,12,18,36,54,12,6,3,9,25,82
Julius Randle,C,23,LAL,82,49,2190,504,904,10,45,494,859,305,425,181,472,653,210,43,45,213,274,1323
Julyan Stone,SG,29,CHO,23,0,175,6,13,6,13,0,0,1,2,1,28,29,26,4,2,7,21,19
Justin Anderson,SF,24,PHI,38,0,519,87,202,34,103,53,99,28,38,25,68,93,25,15,7,16,54,236
Justin Holiday,SG,28,CHI,72,72,2265,290,782,161,449,129,333,135,164,31,260,291,153,80,31,93,134,876
Justin Jackson,SF,22,SAC,68,41,1506,185,419,57,185,128,234,26,36,27,160,187,74,28,13,40,81,453
Justin Patton,C,20,MIN,1,0,4,1,2,0,0,1,2,0,0,0,0,0,0,1,0,0,1,2
Justise Winslow,PF,21,MIA,68,25,1680,207,488,49,129,158,359,66,104,64,305,369,148,54,33,77,140,529
Jusuf Nurkic,C,23,POR,79,79,2088,480,951,0,7,480,944,172,273,189,519,708,143,64,111,183,247,1132
Kadeem Allen,PG,25,BOS,18,1,107,6,22,0,11,6,11,7,9,4,7,11,12,3,2,9,15,19
Karl-Anthony Towns,C,22,MIN,82,82,2918,639,1172,120,285,519,887,345,402,238,774,1012,199,64,115,159,285,1743
Kawhi Leonard,SF,26,SAS,9,9,210,52,111,11,35,41,76,31,38,6,36,42,21,18,9,16,9,146
Kay Felder,PG,22,TOT,16,0,140,21,70,4,19,17,51,11,12,3,15,18,20,3,1,16,11,57
Kelly Olynyk,PF,26,MIA,76,22,1779,316,636,106,280,210,356,134,174,89,342,431,207,62,35,147,222,872
Kelly Oubre,SF,22,WAS,81,11,2231,318,790,126,369,192,421,191,233,59,304,363,98,80,35,90,234,953
Kemba Walker,PG,27,CHO,80,80,2736,588,1363,231,601,357,762,363,420,31,216,247,444,91,24,179,98,1770
Kendrick Perkins,C,33,CLE,1,0,15,1,2,0,0,1,2,1,2,0,1,1,2,1,0,1,1,3
Kenneth Faried,PF,28,DEN,32,7,461,76,148,0,1,76,147,36,51,68,85,153,18,12,13,23,51,188
Kent Bazemore,SG,28,ATL,65,65,1789,284,676,108,274,176,402,160,201,25,223,248,228,100,45,157,147,836
Kentavious Caldwell-Pope,SG,24,LAL,74,74,2458,340,798,159,415,181,383,153,194,60,327,387,162,106,16,97,145,992
Kevin Durant,PF,29,GSW,68,68,2325,630,1222,173,413,457,809,359,404,31,433,464,366,50,119,207,133,1792
Kevin Love,C,29,CLE,59,59,1651,334,729,137,330,197,399,234,266,101,445,546,103,43,24,90,120,1039
Kevon Looney,C,21,GSW,66,4,910,112,193,1,5,111,188,42,77,83,132,215,42,34,56,31,106,267
Khem Birch,C,25,ORL,42,0,578,68,126,0,0,68,126,42,61,70,110,180,34,15,21,21,56,178
Khris Middleton,SF,26,MIL,82,82,2982,593,1272,146,407,447,865,320,362,45,384,429,328,119,21,191,270,1652
Klay Thompson,SG,27,GSW,73,73,2506,575,1178,229,520,346,658,82,98,31,246,277,185,55,34,128,117,1461
Kobi Simmons,PG,20,MEM,32,12,643,80,189,11,39,69,150,25,25,14,36,50,68,18,5,44,61,196
Kosta Koufos,C,28,SAC,71,13,1391,222,389,0,0,222,389,33,74,149,323,472,87,47,32,49,146,477
Kris Dunn,PG,23,CHI,52,43,1525,286,666,43,134,243,532,84,115,24,197,221,310,104,27,150,175,699
Kristaps Porzingis,PF,22,NYK,48,48,1553,390,889,90,228,300,661,218,275,62,254,316,57,36,115,93,141,1088
Kyle Anderson,SF,24,SAS,74,67,1978,231,438,19,57,212,381,104,146,84,312,396,202,115,60,94,114,585
Kyle Collinsworth,SF,26,DAL,32,2,480,38,99,4,17,34,82,21,40,32,75,107,56,17,9,24,44,101
Kyle Korver,SG,36,CLE,73,4,1574,222,484,164,376,58,108,64,72,9,156,165,88,31,27,55,130,672
Kyle Kuzma,PF,22,LAL,77,37,2401,468,1039,159,434,309,605,147,208,88,395,483,141,49,34,140,160,1242
Kyle Lowry,PG,31,TOR,78,78,2510,403,944,238,596,165,348,223,261,66,368,434,537,85,19,183,192,1267
Kyle O'Quinn,C,27,NYK,77,10,1387,224,385,4,17,220,368,98,127,121,349,470,158,35,98,100,192,550
Kyle Singler,SF,29,OKC,12,0,59,7,21,2,5,5,16,7,13,1,9,10,2,1,0,3,4,23
Kyrie Irving,PG,25,BOS,60,60,1931,534,1087,166,407,368,680,232,261,33,194,227,306,65,17,140,122,1466
LaMarcus Aldridge,C,32,SAS,75,75,2509,687,1347,27,92,660,1255,334,399,246,389,635,152,43,90,111,162,1735
Lance Stephenson,SG,27,IND,82,7,1850,303,709,67,232,236,477,84,127,62,362,424,235,46,17,132,177,757
Lance Thomas,PF,29,NYK,73,31,1353,102,267,50,124,52,143,44,53,44,131,175,44,30,14,40,134,298
Langston Galloway,SG,26,DET,58,2,863,126,340,75,218,51,122,33,41,13,79,92,58,35,5,18,39,360
Larry Drew,PG,27,TOT,10,0,70,7,24,3,9,4,15,0,0,3,0,3,10,0,0,3,6,17
Larry Nance,C,25,TOT,66,27,1421,240,413,2,12,238,401,91,137,161,291,452,82,88,38,51,172,573
Lauri Markkanen,PF,20,CHI,68,68,2020,374,862,145,401,229,461,140,166,79,429,508,79,39,40,83,103,1033
LeBron James,PF,33,CLE,82,82,3026,857,1580,149,406,708,1174,388,531,97,612,709,747,116,71,347,135,2251
London Perrantes,PG,23,CLE,14,0,66,2,13,0,3,2,10,3,5,1,3,4,5,2,1,1,6,7
Lonzo Ball,PG,20,LAL,52,50,1780,203,564,90,295,113,269,32,71,69,291,360,376,88,43,136,117,528
Lorenzo Brown,PG,27,TOR,14,0,139,14,34,2,12,12,22,2,2,1,14,15,13,5,0,3,7,32
Lou Williams,SG,31,LAC,79,19,2589,582,1337,186,518,396,819,432,491,40,158,198,417,85,19,234,106,1782
Luc Mbah a Moute,PF,31,HOU,61,15,1564,166,345,63,173,103,172,65,95,22,164,186,55,72,25,69,100,460
Lucas Nogueira,C,25,TOR,49,3,418,49,80,5,19,44,61,19,28,18,69,87,22,23,43,16,49,122
Luis Montero,SG,24,DET,2,0,8,0,1,0,0,0,1,0,0,0,2,2,0,0,0,2,0,0
Luke Babbitt,SF,28,TOT,50,14,715,91,215,60,156,31,59,17,22,7,89,96,31,8,7,19,54,259
Luke Kennard,SG,21,DET,73,9,1463,206,465,81,195,125,270,65,76,21,155,176,124,44,13,69,86,558
Luke Kornet,PF,22,NYK,20,1,326,49,125,28,79,21,46,8,11,11,53,64,26,6,16,12,28,134
Luol Deng,SF,32,LAL,1,1,13,1,2,0,0,1,2,0,0,0,0,0,1,1,0,1,0,2
Malachi Richardson,SG,22,TOT,26,4,324,30,90,12,40,18,50,17,22,5,29,34,13,10,1,10,27,89
Malcolm Brogdon,PG,25,MIL,48,20,1436,244,503,62,161,182,342,75,85,23,133,156,152,41,13,66,128,625
Malcolm Delaney,PG,28,ATL,54,3,1014,109,285,46,124,63,161,74,92,9,91,100,163,35,6,66,82,338
Malcolm Miller,SF,24,TOR,15,4,126,13,28,8,21,5,7,4,4,4,11,15,3,1,2,5,10,38
Malik Beasley,SG,21,DEN,62,0,583,73,178,28,82,45,96,22,33,14,57,71,31,15,7,24,36,196
Malik Monk,SG,19,CHO,63,0,854,153,425,83,243,70,182,32,38,8,58,66,91,20,9,48,59,421
Mangok Mathiang,C,25,CHO,4,0,20,4,7,0,0,4,7,0,1,3,7,10,0,1,0,0,5,8
Manu Ginobili,SG,40,SAS,65,0,1299,201,463,64,192,137,271,110,131,19,123,142,163,43,16,105,126,576
Marc Gasol,C,33,MEM,73,73,2408,434,1033,109,320,325,713,281,337,78,514,592,305,54,101,194,185,1258
Marcin Gortat,C,33,WAS,82,82,2075,290,560,0,0,290,560,110,163,181,442,623,151,40,61,99,175,690
Marco Belinelli,SG,31,TOT,80,2,1947,337,763,149,395,188,368,148,163,19,131,150,148,66,12,94,91,971
Marcus Georges-Hunt,SG,23,MIN,42,0,224,21,48,4,15,17,33,13,21,7,9,16,7,6,0,3,32,59
Marcus Morris,PF,28,BOS,54,21,1447,262,611,86,234,176,377,124,154,43,246,289,72,35,12,65,100,734
Marcus Paige,PG,24,CHO,5,0,28,4,14,2,8,2,6,2,2,0,4,4,3,0,0,0,0,12
Marcus Smart,SG,23,BOS,54,11,1614,189,515,75,249,114,266,97,133,43,146,189,259,71,23,129,133,550
Mario Chalmers,PG,31,MEM,66,10,1421,168,443,53,191,115,252,118,138,13,144,157,197,79,14,117,179,507
Mario Hezonja,SF,22,ORL,75,30,1657,273,617,90,267,183,350,86,105,41,240,281,106,81,30,86,134,722
Markel Brown,SG,26,HOU,4,0,31,2,7,1,5,1,2,0,0,1,4,5,2,0,0,2,6,5
Markelle Fultz,SG,19,PHI,14,0,253,45,111,0,1,45,110,10,21,11,32,43,53,12,4,17,22,100
Markieff Morris,PF,28,WAS,73,73,1968,330,687,76,207,254,480,105,128,75,334,409,142,56,38,127,216,841
Marquese Chriss,PF,20,PHO,72,49,1527,202,477,56,190,146,287,96,158,76,319,395,83,51,70,107,205,556
Marquis Teague,PG,24,MEM,3,0,74,4,16,1,4,3,12,2,5,1,5,6,13,4,0,3,5,11
Marreese Speights,C,30,ORL,52,3,675,138,349,86,233,52,116,40,55,21,112,133,40,8,22,40,107,402
Marshall Plumlee,C,25,MIL,8,0,52,1,3,0,0,1,3,12,16,4,13,17,2,0,1,3,10,14
MarShon Brooks,SG,29,MEM,7,1,193,51,102,19,32,32,70,20,23,9,13,22,25,11,3,16,6,141
Marvin Williams,PF,31,CHO,78,78,2006,258,563,126,305,132,258,102,123,74,296,370,96,56,38,66,116,744
Mason Plumlee,C,27,DEN,74,26,1439,221,368,0,1,221,367,82,180,132,268,400,142,49,81,103,184,524
Matt Costello,C,24,SAS,4,0,32,2,4,0,0,2,4,0,0,1,8,9,2,2,2,1,7,4
Matt Williams,SG,24,MIA,3,0,11,2,6,1,5,1,1,0,0,0,1,1,0,0,0,1,1,5
Matthew Dellavedova,PG,27,MIL,38,3,712,55,152,29,78,26,74,25,27,14,50,64,145,14,0,49,67,164
Maurice Harkless,SF,24,POR,59,36,1264,147,297,49,118,98,179,42,59,46,116,162,53,48,43,40,103,385
Maxi Kleber,PF,26,DAL,72,36,1206,151,309,40,128,111,181,44,59,71,163,234,51,26,47,30,114,386
Meyers Leonard,C,25,POR,33,2,254,46,78,11,26,35,52,9,11,12,58,70,17,7,0,10,36,112
Michael Beasley,PF,29,NYK,74,30,1653,409,807,34,86,375,721,124,159,97,317,414,123,36,43,143,145,976
Michael Carter-Williams,PG,26,CHO,52,2,835,76,229,14,59,62,170,73,89,37,101,138,116,44,23,52,99,239
Michael Kidd-Gilchrist,SF,24,CHO,74,74,1850,282,560,0,2,282,558,117,171,84,218,302,71,51,32,54,143,681
Mike Conley,PG,30,MEM,12,12,373,64,168,24,77,40,91,53,66,0,27,27,49,12,3,18,24,205
Mike James,PG,27,TOT,36,10,687,123,321,26,98,97,223,64,84,13,77,90,126,28,7,49,48,336
Mike Muscala,C,26,ATL,53,7,1060,143,312,62,167,81,145,57,62,56,174,230,51,31,27,42,80,405
Mike Scott,PF,29,WAS,76,1,1406,276,524,66,163,210,361,50,76,50,197,247,80,23,10,79,148,668
Miles Plumlee,C,29,ATL,55,35,918,105,180,0,0,105,180,27,60,77,151,228,45,17,30,63,79,237
Milos Teodosic,PG,30,LAC,45,36,1134,151,360,88,232,63,128,39,46,16,110,126,209,23,5,97,103,429
Milton Doyle,SG,24,BRK,10,0,125,13,47,4,23,9,24,4,8,3,15,18,10,6,2,2,13,34
Mindaugas Kuzminskas,SF,28,NYK,1,0,2,0,2,0,0,0,2,0,0,0,0,0,0,0,0,0,0,0
Mirza Teletovic,PF,32,MIL,10,0,159,25,57,21,45,4,12,0,0,3,20,23,10,4,1,7,14,71
Monte Morris,PG,22,DEN,3,0,25,4,6,0,1,4,5,2,2,0,2,2,7,3,0,1,1,10
Montrezl Harrell,C,24,LAC,76,3,1293,348,548,1,7,347,541,139,222,103,203,306,74,36,52,68,143,836
Myke Henry,SF,25,MEM,20,0,378,41,109,19,58,22,51,6,10,10,28,38,22,31,6,19,28,107
Myles Turner,C,21,IND,65,62,1836,306,639,56,157,250,482,160,206,93,324,417,87,38,118,96,186,828
Nate Wolters,PG,26,UTA,5,0,19,1,6,0,0,1,6,0,0,1,1,2,1,0,0,0,1,2
Naz Mitrou-Long,SG,24,UTA,1,0,1,1,1,1,1,0,0,0,0,0,0,0,0,0,0,0,0,3
Nemanja Bjelica,PF,29,MIN,67,21,1371,171,371,76,183,95,188,36,45,53,221,274,86,50,16,52,141,454
Nene Hilario,C,35,HOU,52,4,758,136,239,0,2,136,237,68,107,54,122,176,45,28,14,38,123,340
Nerlens Noel,C,23,DAL,30,6,472,55,105,0,1,55,104,21,28,48,120,168,20,31,22,26,59,131
Nick Collison,PF,37,OKC,15,0,75,13,19,0,0,13,19,5,13,7,13,20,4,0,0,7,7,31
Nick Young,SG,32,GSW,80,8,1393,201,488,123,326,78,162,56,65,20,105,125,36,38,7,40,100,581
Nicolas Batum,SG,29,CHO,64,64,1981,270,650,92,274,178,376,108,130,57,249,306,349,65,23,131,72,740
Nicolas Brussino,SF,24,ATL,4,0,10,0,2,0,2,0,0,0,0,0,3,3,0,0,0,0,0,0
Nigel Hayes,SF,23,TOT,9,0,122,11,33,4,16,7,17,1,3,4,18,22,6,2,3,2,8,27
Nik Stauskas,SG,24,TOT,41,0,523,60,154,40,100,20,54,21,29,4,60,64,39,9,4,26,24,181
Nikola Jokic,C,22,DEN,75,73,2443,504,1010,111,280,393,730,266,313,195,608,803,458,90,61,210,212,1385
Nikola Mirotic,PF,26,TOT,55,14,1494,306,684,135,358,171,326,112,137,59,346,405,80,44,39,62,108,859
Nikola Vucevic,C,27,ORL,57,57,1683,399,840,64,204,335,636,77,94,101,422,523,191,56,63,109,144,939
Noah Vonleh,PF,22,TOT,54,16,875,104,234,20,66,84,168,36,58,70,241,311,34,19,17,31,68,264
Norman Powell,SG,24,TOR,70,18,1062,150,374,53,186,97,188,32,39,14,105,119,89,37,16,66,111,385
OG Anunoby,SF,20,TOR,74,62,1481,163,346,73,197,90,149,39,62,44,140,184,55,52,14,45,130,438
Okaro White,PF,25,MIA,6,4,80,7,16,4,11,3,5,2,3,3,8,11,2,1,1,1,6,20
Omari Johnson,PF,28,MEM,4,0,75,9,21,4,12,5,9,0,0,4,7,11,7,2,0,3,6,22
Omer Asik,C,31,TOT,18,0,182,9,22,0,0,9,22,4,13,9,38,47,3,2,4,9,20,22
Omri Casspi,SF,29,GSW,53,7,740,120,207,10,22,110,185,50,69,30,170,200,51,18,19,37,70,300
Otto Porter,SF,24,WAS,77,77,2432,445,885,138,313,307,572,106,128,103,389,492,157,116,41,75,151,1134
P.J. Tucker,PF,32,HOU,82,34,2281,172,441,115,310,57,131,43,60,93,364,457,77,78,26,74,205,502
Pascal Siakam,PF,23,TOR,81,5,1679,253,498,29,132,224,366,54,87,79,285,364,159,62,42,67,166,589
Pat Connaughton,SG,25,POR,82,5,1488,165,390,74,210,91,180,37,44,36,125,161,91,23,22,43,120,441
Patrick Beverley,SG,29,LAC,11,11,334,48,119,24,60,24,59,14,17,16,29,45,32,18,5,25,34,134
Patrick McCaw,SG,22,GSW,57,10,961,92,225,19,80,73,145,26,34,16,66,82,81,43,10,41,67,229
Patrick Patterson,PF,28,OKC,82,3,1270,106,266,66,171,40,95,40,46,32,161,193,57,48,23,33,87,318
Patty Mills,PG,29,SAS,82,36,2107,280,682,154,414,126,268,105,118,26,128,154,229,55,11,106,128,819
Pau Gasol,C,37,SAS,77,63,1812,287,627,43,120,244,507,158,209,129,490,619,238,24,79,108,121,775
Paul George,SF,27,OKC,79,79,2891,576,1339,244,608,332,731,338,412,72,375,447,263,161,39,212,233,1734
Paul Millsap,PF,32,DEN,38,37,1143,202,435,39,113,163,322,112,161,65,180,245,103,39,44,73,99,555
Paul Zipser,SF,23,CHI,54,12,824,81,234,37,110,44,124,19,26,13,118,131,46,20,15,43,86,218
PJ Dozier,PG,21,OKC,2,0,3,1,2,0,0,1,2,0,0,0,1,1,0,0,0,1,1,2
Quincy Acy,PF,27,BRK,70,8,1359,130,365,102,292,28,73,49,60,40,216,256,57,33,29,60,149,411
Quincy Pondexter,SF,29,CHI,23,1,196,14,49,3,22,11,27,14,17,8,19,27,9,8,2,11,24,45
Quinn Cook,PG,24,GSW,33,18,740,122,252,46,104,76,148,22,25,10,72,82,89,12,1,32,59,312
R.J. Hunter,SG,24,HOU,5,1,45,7,20,3,14,4,6,2,2,0,5,5,3,3,0,2,7,19
Rajon Rondo,PG,31,NOP,65,63,1705,231,494,50,150,181,344,25,46,31,232,263,533,70,10,151,119,537
Ramon Sessions,PG,31,TOT,28,3,392,42,117,8,26,34,91,44,57,6,32,38,77,14,2,30,29,136
Rashad Vaughn,SG,21,TOT,28,0,212,23,56,14,37,9,19,4,6,3,18,21,13,5,3,6,15,64
Raul Neto,PG,25,UTA,41,0,498,69,151,19,47,50,104,26,35,7,42,49,75,13,4,36,38,183
Raymond Felton,PG,33,OKC,82,2,1365,224,552,81,230,143,322,36,44,25,131,156,203,49,16,76,91,565
Reggie Bullock,SF,26,DET,62,52,1732,267,546,125,281,142,265,39,49,27,127,154,95,47,13,47,70,698
Reggie Hearn,SG,26,DET,3,0,7,1,2,1,2,0,0,0,0,0,0,0,0,0,0,0,0,3
Reggie Jackson,PG,27,DET,45,45,1201,246,577,52,169,194,408,112,134,29,96,125,238,27,4,99,87,656
Richard Jefferson,SF,37,DEN,20,0,163,12,27,2,7,10,20,4,7,2,15,17,15,2,1,5,11,30
Richaun Holmes,C,24,PHI,48,2,746,135,241,4,31,131,210,37,56,57,154,211,61,20,29,25,97,311
Ricky Rubio,PG,27,UTA,77,77,2254,346,827,96,273,250,554,220,254,44,307,351,410,121,11,207,206,1008
Robert Covington,SF,27,PHI,80,80,2532,345,836,203,550,142,286,116,136,55,378,433,156,137,72,126,238,1009
Robin Lopez,C,29,CHI,64,64,1690,342,645,4,14,338,631,68,90,134,156,290,124,14,53,107,109,756
Rodney Hood,SG,25,TOT,60,23,1616,322,751,127,333,195,418,111,129,22,143,165,95,45,12,70,105,882
Rodney McGruder,SG,26,MIA,18,2,299,36,73,15,35,21,38,4,8,11,21,32,17,8,3,4,21,91
Rodney Purvis,SG,23,ORL,16,2,290,35,107,13,52,22,55,13,15,1,26,27,17,3,3,10,26,96
Ron Baker,SG,24,NYK,29,1,385,20,59,11,33,9,26,20,26,5,25,30,47,26,6,18,33,71
Rondae Hollis-Jefferson,SF,23,BRK,68,59,1920,342,724,13,54,329,670,249,316,101,358,459,167,65,48,121,145,946
Royce O'Neale,SF,24,UTA,69,4,1150,120,284,42,118,78,166,61,76,25,211,236,95,36,16,55,105,343
Rudy Gay,PF,31,SAS,57,6,1231,253,537,37,118,216,419,112,145,76,215,291,73,46,38,78,98,655
Rudy Gobert,C,25,UTA,56,56,1816,276,444,0,0,276,444,204,299,165,436,601,80,44,129,107,153,756
Russell Westbrook,PG,29,OKC,80,80,2914,757,1687,97,326,660,1361,417,566,152,652,804,820,147,20,381,200,2028
Ryan Anderson,PF,29,HOU,66,50,1725,207,480,131,339,76,141,72,93,94,237,331,60,24,21,42,126,617
Ryan Arcidiacono,PG,23,CHI,24,0,304,17,41,9,31,8,10,5,6,1,24,25,35,13,0,13,18,48
Salah Mejri,C,31,DAL,61,1,729,88,137,0,3,88,134,38,66,85,161,246,35,22,67,39,121,214
Sam Dekker,PF,23,LAC,73,1,883,128,259,10,60,118,199,37,56,44,130,174,38,24,9,33,71,303
Scotty Hopson,SG,28,DAL,1,0,8,0,1,0,0,0,1,1,2,0,0,0,1,0,0,1,0,1
Sean Kilpatrick,SG,28,TOT,52,1,640,110,294,46,144,64,150,64,72,5,82,87,46,13,5,38,33,330
Semi Ojeleye,PF,23,BOS,73,0,1150,65,188,40,125,25,63,25,41,37,124,161,20,21,4,25,91,195
Serge Ibaka,PF,28,TOR,76,76,2093,379,784,107,297,272,487,94,118,78,400,478,62,29,99,90,210,959
Shabazz Muhammad,SF-SG,25,TOT,43,2,418,84,188,7,27,77,161,39,50,23,53,76,14,9,3,6,30,214
Shabazz Napier,PG,26,POR,74,10,1535,223,531,82,218,141,313,116,138,26,144,170,150,81,14,90,84,644
Shane Larkin,PG,25,BOS,54,2,775,84,219,31,86,53,133,32,37,15,77,92,98,29,3,33,58,231
Shaquille Harrison,PG,24,PHO,23,2,384,59,124,6,26,53,98,28,38,9,52,61,55,26,7,22,42,152
Shaun Livingston,PG,32,GSW,71,7,1129,172,343,0,5,172,338,50,61,32,99,131,140,35,21,58,117,394
Shelvin Mack,PG,27,ORL,69,3,1365,178,414,48,139,130,275,69,97,23,143,166,272,54,8,89,91,473
Sindarius Thornwell,SG,23,LAC,73,17,1156,100,233,23,61,77,172,59,88,33,107,140,68,48,25,53,125,282
Skal Labissiere,PF,21,SAC,60,28,1240,205,458,18,51,187,407,95,118,99,189,288,72,25,49,73,132,523
Solomon Hill,SF,26,NOP,12,1,187,11,41,4,21,7,20,3,6,9,27,36,22,7,1,9,22,29
Spencer Dinwiddie,PG,24,BRK,80,58,2306,324,838,141,433,183,405,218,268,40,219,259,524,68,23,128,186,1007
Stanley Johnson,SF,21,DET,69,50,1894,210,560,67,234,143,326,112,145,33,219,252,112,95,14,77,169,599
Stephen Curry,PG,29,GSW,51,51,1631,428,864,212,501,216,363,278,302,36,225,261,310,80,8,153,114,1346
Sterling Brown,SG,22,MIL,54,4,776,82,205,32,91,50,114,21,24,27,116,143,25,31,13,25,80,217
Steven Adams,C,24,OKC,76,76,2487,448,712,0,2,448,710,160,287,384,301,685,88,92,78,128,215,1056
T.J. Leaf,PF,20,IND,53,0,459,64,136,18,42,46,94,10,16,29,53,82,9,5,4,10,45,156
T.J. McConnell,PG,25,PHI,76,1,1706,210,421,27,62,183,359,31,39,37,189,226,303,92,13,112,122,478
T.J. Warren,SF,24,PHO,65,65,2142,529,1063,20,90,509,973,193,255,125,208,333,85,65,41,85,149,1271
Taj Gibson,PF,32,MIN,82,82,2726,425,737,7,35,418,702,142,185,194,390,584,99,62,59,89,218,999
Tarik Black,C,26,HOU,51,2,536,75,127,1,11,74,116,29,63,63,100,163,13,21,30,35,107,180
Taurean Waller-Prince,SF,23,ATL,82,82,2464,415,975,176,457,239,518,152,180,50,339,389,214,85,42,191,168,1158
Terrance Ferguson,SG,19,OKC,61,12,763,70,169,40,120,30,49,9,10,19,28,47,19,24,10,11,83,189
Terrence Ross,SG,26,ORL,24,20,600,76,191,30,93,46,98,27,36,10,63,73,38,27,11,29,45,209
Terry Rozier,PG,23,BOS,80,16,2068,316,800,153,402,163,398,115,149,63,313,376,232,80,19,80,123,900
Thabo Sefolosha,SF,33,UTA,38,6,806,118,240,32,84,86,156,44,54,29,132,161,33,52,12,30,59,312
Thaddeus Young,PF,29,IND,81,81,2607,421,864,58,181,363,683,55,92,184,328,512,152,135,36,105,175,955
Thomas Bryant,C,20,LAL,15,0,72,8,21,1,10,7,11,5,9,3,14,17,6,1,2,2,6,22
Thon Maker,C,20,MIL,74,12,1238,130,316,31,104,99,212,65,93,75,150,225,46,38,53,44,162,356
Tim Frazier,PG,27,WAS,59,11,838,68,172,17,56,51,116,23,30,18,97,115,194,47,7,57,97,176
Tim Hardaway,SG,25,NYK,57,54,1885,360,856,130,410,230,446,146,179,32,192,224,155,62,10,92,123,996
Tim Quarterman,SG,23,HOU,3,0,13,1,3,0,2,1,1,2,2,0,3,3,1,0,0,2,1,4
Timofey Mozgov,C,31,BRK,31,13,359,52,93,4,18,48,75,23,30,32,66,98,11,5,13,33,39,131
Timothe Luwawu-Cabarrot,SF,22,PHI,52,7,807,100,267,53,158,47,109,46,58,14,58,72,54,12,5,38,97,299
Tobias Harris,PF,25,TOT,80,80,2668,562,1221,183,445,379,776,179,216,58,379,437,192,71,35,105,164,1486
Tomas Satoransky,SG,26,WAS,73,30,1643,201,384,47,101,154,283,75,96,72,161,233,286,51,15,83,131,524
Tony Allen,SF,36,NOP,22,0,273,44,91,4,12,40,79,11,21,20,27,47,9,11,3,19,49,103
Tony Bradley,C,20,UTA,9,0,29,3,11,0,1,3,10,2,2,4,7,11,1,0,0,0,1,8
Tony Parker,PG,35,SAS,55,21,1071,178,388,10,37,168,351,55,78,7,88,95,195,28,1,68,52,421
Tony Snell,SG,26,MIL,75,59,2053,185,425,108,268,77,157,38,48,9,132,141,98,47,28,36,115,516
Torrey Craig,SF,27,DEN,39,5,629,62,137,17,58,45,79,22,35,40,87,127,25,12,15,20,63,163
Travis Wear,SF,27,LAL,17,0,228,25,72,17,47,8,25,8,8,0,38,38,7,4,5,6,30,75
Treveon Graham,SG,24,CHO,63,2,1050,96,221,40,97,56,124,41,59,42,79,121,59,33,2,27,109,273
Trevor Ariza,SF,32,HOU,67,67,2269,268,651,170,462,98,189,76,89,33,261,294,105,98,13,52,132,782
Trevor Booker,PF,30,TOT,68,7,1158,177,343,8,33,169,310,66,93,117,201,318,82,28,21,59,120,428
Trey Burke,PG,25,NYK,36,9,785,193,384,38,105,155,279,37,57,13,58,71,170,24,4,43,43,461
Trey Lyles,PF,22,DEN,73,2,1391,270,550,83,218,187,332,101,145,55,292,347,91,30,34,61,111,724
Trey McKinney-Jones,SG,27,IND,1,0,1,0,0,0,0,0,0,0,0,0,0,0,0,0,0,0,0,0
Tristan Thompson,C,26,CLE,53,22,1072,132,235,0,0,132,235,43,79,126,226,352,33,16,17,36,102,307
Troy Daniels,SG,26,PHO,79,15,1622,232,575,183,458,49,117,56,64,12,115,127,48,26,5,56,137,703
Troy Williams,SF,23,TOT,21,1,307,51,109,11,38,40,71,20,30,22,41,63,16,20,4,19,34,133
Tyler Cavanaugh,PF,23,ATL,39,1,518,67,152,32,89,35,63,17,21,45,82,127,27,9,4,14,61,183
Tyler Dorsey,SG,21,ATL,56,5,974,144,383,72,200,72,183,45,63,17,113,130,79,17,5,37,63,405
Tyler Ennis,PG,23,LAL,54,11,683,94,224,14,56,80,168,22,29,19,77,96,105,30,10,38,75,224
Tyler Johnson,PG,25,MIA,72,39,2052,309,711,119,324,190,387,106,129,34,214,248,165,60,34,81,148,843
Tyler Lydon,PF,21,DEN,1,0,2,0,0,0,0,0,0,0,0,0,0,0,0,0,0,0,0,0
Tyler Ulis,PG,22,PHO,71,43,1658,214,551,42,146,172,405,84,101,24,104,128,311,70,7,127,120,554
Tyler Zeller,C,28,TOT,66,34,1109,187,334,10,28,177,306,57,79,110,195,305,47,15,35,47,126,441
Tyreke Evans,PG,28,MEM,52,32,1607,366,809,114,286,252,523,164,209,44,221,265,269,57,17,117,96,1010
Tyrone Wallace,PG,23,LAC,30,19,851,110,247,10,40,100,207,61,78,21,84,105,71,27,13,46,83,291
Tyson Chandler,C,35,PHO,46,46,1151,121,187,0,0,121,187,58,94,134,284,418,53,16,27,59,106,300
Tyus Jones,PG,21,MIN,82,11,1467,150,328,45,129,105,199,71,81,16,116,132,232,95,6,59,110,416
Udonis Haslem,C,37,MIA,14,0,72,3,15,1,8,2,7,1,2,3,7,10,5,0,2,2,3,8
Vander Blue,SG,25,LAL,5,0,45,1,5,0,2,1,3,1,2,0,1,1,3,1,0,3,2,3
Victor Oladipo,SG,25,IND,75,75,2552,640,1342,161,434,479,908,294,368,47,343,390,323,177,57,219,175,1735
Vince Carter,SF,41,SAC,58,5,1026,114,283,57,165,57,118,28,37,18,130,148,69,42,26,36,96,313
Vince Hunter,PF,23,MEM,4,0,7,3,5,0,0,3,5,0,0,2,1,3,0,0,1,1,0,6
Wade Baldwin,PG,21,POR,7,0,80,14,21,4,5,10,16,6,10,1,7,8,5,2,1,4,12,38
Walt Lemon Jr.,PG,25,NOP,5,0,35,7,16,1,1,6,15,2,3,0,2,2,5,0,1,4,5,17
Wayne Ellington,SG,30,MIA,77,2,2041,285,700,227,579,58,121,67,78,23,195,218,79,53,8,52,94,864
Wayne Selden,SG,23,MEM,35,9,692,116,269,49,122,67,147,44,59,16,40,56,66,18,5,54,59,325
Wesley Iwundu,SF,23,ORL,62,12,1020,93,218,9,46,84,172,34,47,36,101,137,57,33,12,30,81,229
Wesley Johnson,SF,30,LAC,74,40,1486,150,368,60,177,90,191,43,58,29,187,216,61,76,62,55,146,403
Wesley Matthews,SF,31,DAL,63,62,2131,283,697,153,402,130,295,83,101,28,170,198,172,76,16,83,140,802
Will Barton,SG,27,DEN,81,40,2683,465,1028,156,422,309,606,182,226,70,339,409,331,82,52,149,168,1268
Willie Cauley-Stein,C,24,SAC,73,58,2044,388,773,3,12,385,761,153,247,131,379,510,172,77,67,109,185,932
Willie Reed,C,27,TOT,42,5,428,81,121,1,2,80,119,32,55,35,86,121,10,9,22,19,56,195
Willy Hernangomez,C,23,TOT,48,1,495,91,164,5,12,86,152,59,90,60,122,182,33,18,16,34,64,246
Wilson Chandler,SF,30,DEN,74,71,2346,281,631,88,246,193,385,88,114,102,296,398,160,43,39,92,156,738
Xavier Munford,SG,25,MIL,6,0,21,1,6,0,2,1,4,1,2,1,0,1,4,1,0,2,4,3
Xavier Rathan-Mayes,SG,23,MEM,5,0,118,12,42,1,14,11,28,4,9,0,5,5,18,6,3,11,18,29
Xavier Silas,SG,30,BOS,2,0,7,0,3,0,2,0,1,0,0,1,1,2,0,1,0,0,1,0
Yogi Ferrell,SG,24,DAL,82,21,2282,311,730,134,359,177,371,82,103,26,223,249,201,64,9,78,153,838
Zach Collins,C,20,POR,66,1,1045,115,289,35,113,80,176,27,42,45,176,221,52,17,31,58,133,292
Zach LaVine,SG,22,CHI,24,24,656,136,355,42,123,94,232,87,107,9,85,94,72,24,4,43,55,401
Zach Randolph,PF,36,SAC,59,57,1508,361,763,51,147,310,616,84,107,97,300,397,127,42,10,116,119,857
Zaza Pachulia,C,33,GSW,69,57,972,149,264,0,1,149,263,75,93,89,232,321,109,38,17,72,122,373
Zhou Qi,C,22,HOU,18,0,124,6,32,2,19,4,13,8,12,6,16,22,2,2,14,10,14,22