Player,Pos,Age,Tm,G,GS,MP,FG,FGA,3P,3PA,2P,2PA,FT,FTA,ORB,DRB,TRB,AST,STL,BLK,TOV,PF,PTS
A.J. Hammons,C,24,DAL,22,0,163,17,42,5,10,12,32,9,20,8,28,36,4,1,13,10,21,48
Aaron Brooks,PG,32,IND,65,0,894,121,300,48,128,73,172,32,40,18,51,69,125,25,9,66,93,322
Aaron Gordon,SF,21,ORL,80,72,2298,393,865,77,267,316,598,156,217,116,289,405,150,65,40,89,172,1019
Aaron Harrison,SG,22,CHO,5,0,17,0,4,0,2,0,2,1,2,0,3,3,3,0,0,0,2,1
Adreian Payne,PF,25,MIN,18,0,135,23,54,3,15,20,39,14,19,9,24,33,7,8,7,8,32,63
Al Horford,C,30,BOS,68,68,2193,379,801,86,242,293,559,108,135,95,370,465,337,52,86,115,138,952
Al Jefferson,C,32,IND,66,1,931,235,471,0,1,235,470,65,85,75,203,278,57,19,16,33,125,535
Al-Farouq Aminu,PF,26,POR,61,25,1773,183,466,70,212,113,254,96,136,77,374,451,99,60,44,94,102,532
Alan Anderson,SF,34,LAC,30,0,308,30,80,14,44,16,36,12,16,3,21,24,11,3,0,7,35,86
Alan Williams,C,24,PHO,47,0,708,138,267,0,1,138,266,70,112,94,198,292,23,27,32,37,125,346
Alec Burks,SG,25,UTA,42,0,653,99,248,25,76,74,172,60,78,17,103,120,30,18,5,35,50,283
Alex Abrines,SG,23,OKC,68,6,1055,134,341,94,247,40,94,44,49,18,68,86,40,37,8,33,114,406
Alex Len,C,23,PHO,77,34,1560,230,463,3,12,227,451,150,208,156,354,510,44,38,98,102,242,613
Alex Poythress,PF,23,PHI,6,1,157,25,54,6,19,19,35,8,10,11,18,29,5,3,2,3,14,64
Alexis Ajinca,C,28,NOP,39,15,584,89,178,0,4,89,174,29,40,46,131,177,12,20,22,31,77,207
Allen Crabbe,SG,24,POR,79,7,2254,303,647,134,302,169,345,105,124,19,207,226,94,54,20,62,171,845
Alonzo Gee,SF,29,DEN,13,0,89,3,14,0,3,3,11,5,9,4,11,15,6,5,1,4,14,11
Amir Johnson,PF,29,BOS,80,77,1608,213,370,27,66,186,304,67,100,118,248,366,140,51,62,77,211,520
Anderson Varejao,C,34,GSW,14,1,92,5,14,0,0,5,14,8,11,12,15,27,10,3,3,8,16,18
Andre Drummond,C,23,DET,81,81,2409,483,911,2,7,481,904,137,355,345,770,1115,90,124,89,152,237,1105
Andre Iguodala,SF,33,GSW,76,0,1998,219,415,64,177,155,238,72,102,51,253,304,261,76,39,58,97,574
Andre Roberson,SF,25,OKC,79,79,2376,215,463,45,184,170,279,47,111,98,305,403,79,94,79,51,204,522
Andrew Bogut,C,32,TOT,27,21,583,38,81,0,1,38,80,3,11,56,162,218,49,13,25,43,86,79
Andrew Harrison,PG,22,MEM,72,18,1474,117,360,43,156,74,204,148,194,23,113,136,198,53,21,85,194,425
Andrew Nicholson,PF,27,TOT,38,0,342,43,111,5,27,38,84,9,14,15,46,61,10,16,6,17,55,100
Andrew Wiggins,SF,21,MIN,82,82,3048,709,1570,103,289,606,1281,412,542,102,226,328,189,82,30,187,183,1933
Anthony Bennett,PF,23,BRK,23,1,264,38,92,13,48,25,44,26,36,25,53,78,12,5,3,12,18,115
Anthony Brown,SF,24,TOT,11,0,159,18,50,7,27,11,23,0,0,8,25,33,8,5,1,6,15,43
Anthony Davis,C,23,NOP,75,75,2708,770,1526,40,134,730,1392,519,647,172,712,884,157,94,167,181,168,2099
Anthony Morrow,SG,31,TOT,49,7,714,98,252,41,133,57,119,34,37,12,19,31,25,24,2,6,44,271
Anthony Tolliver,PF,31,SAC,65,9,1477,155,351,90,230,65,121,61,82,51,186,237,77,34,20,56,109,461
Archie Goodwin,SG,22,TOT,15,0,214,36,66,5,15,31,51,33,42,7,21,28,24,4,5,14,8,110
Arinze Onuaku,C,29,ORL,8,0,28,2,4,0,0,2,4,0,0,2,4,6,2,0,1,2,3,4
Aron Baynes,C,30,DET,75,2,1163,143,279,0,0,143,279,79,94,111,222,333,32,17,39,50,166,365
Arron Afflalo,SG,31,SAC,61,45,1580,185,420,62,151,123,269,83,93,9,116,125,78,21,6,42,104,515
Austin Rivers,SG,24,LAC,74,29,2054,323,731,111,299,212,432,132,191,20,141,161,204,48,10,115,187,889
Avery Bradley,SG,26,BOS,55,55,1835,359,775,108,277,251,498,68,93,65,269,334,122,68,11,88,141,894
Axel Toupane,SF,24,TOT,4,0,47,5,9,1,4,4,5,0,0,0,1,1,0,1,1,0,6,11
Ben Bentil,PF,21,DAL,3,0,10,0,3,0,1,0,2,0,0,0,2,2,0,0,0,1,1,0
Ben McLemore,SG,23,SAC,61,26,1176,180,419,65,170,115,249,70,93,19,110,129,51,29,6,62,108,495
Beno Udrih,PG,34,DET,39,0,560,92,197,11,32,81,165,32,34,6,51,57,131,13,0,36,29,227
Bismack Biyombo,C,24,ORL,81,27,1793,179,339,0,0,179,339,125,234,157,410,567,74,25,91,95,202,483
Blake Griffin,PF,27,LAC,61,61,2076,479,971,38,113,441,858,320,421,112,385,497,300,57,22,142,157,1316
Boban Marjanovic,C,28,DET,35,0,293,72,132,0,0,72,132,47,58,46,84,130,9,6,12,10,25,191
Bobby Brown,PG,32,HOU,25,0,123,23,60,14,35,9,25,2,2,0,6,6,14,1,0,5,5,62
Bobby Portis,PF,21,CHI,64,13,1000,183,375,32,96,151,279,39,59,75,221,296,35,16,11,37,94,437
Bojan Bogdanovic,SF,27,TOT,81,54,2083,376,845,144,392,232,453,217,243,37,240,277,111,34,7,131,146,1113
Boris Diaw,PF,34,UTA,73,33,1283,146,327,20,81,126,246,26,35,46,112,158,170,18,9,87,83,338
Bradley Beal,SG,23,WAS,77,77,2684,637,1322,223,552,414,770,282,342,53,187,240,267,83,21,156,169,1779
Brandan Wright,PF,29,MEM,28,5,447,83,135,0,1,83,134,23,35,31,47,78,15,11,20,10,42,189
Brandon Bass,PF,31,LAC,52,0,577,107,186,1,3,106,183,77,88,43,86,129,21,14,11,29,45,292
Brandon Ingram,SF,19,LAL,79,40,2279,276,686,55,187,221,499,133,214,60,256,316,166,50,36,116,158,740
Brandon Jennings,PG,27,TOT,81,13,1802,192,535,79,252,113,283,114,152,29,167,196,395,70,4,128,116,577
Brandon Knight,SG,25,PHO,54,5,1140,209,525,45,139,164,386,132,154,25,93,118,130,27,5,88,87,595
Brandon Rush,SG,31,MIN,47,33,1030,70,187,44,114,26,73,13,18,16,83,99,45,22,23,28,42,197
Brian Roberts,PG,31,CHO,41,2,416,46,122,17,44,29,78,33,39,5,34,39,52,9,1,26,18,142
Briante Weber,PG,24,TOT,20,0,205,25,60,1,10,24,50,11,16,8,18,26,21,12,1,8,16,62
Brice Johnson,PF,22,LAC,3,0,9,2,7,0,0,2,7,0,0,1,2,3,1,2,1,1,0,4
Brook Lopez,C,28,BRK,75,75,2222,555,1172,134,387,421,785,295,364,121,282,403,176,38,124,184,192,1539
Bruno Caboclo,SF,21,TOR,9,0,40,6,16,2,6,4,10,0,0,5,5,10,4,2,1,2,4,14
Bryn Forbes,SG,23,SAS,36,0,285,36,99,17,53,19,46,5,6,2,21,23,23,1,0,11,20,94
Buddy Hield,SG,23,TOT,82,55,1888,327,767,148,379,179,388,64,76,35,234,269,121,38,9,101,115,866
C.J. McCollum,SG,25,POR,80,80,2796,692,1441,185,439,507,1002,268,294,60,229,289,285,72,42,172,202,1837
C.J. Miles,SF,29,IND,76,29,1776,281,647,169,409,112,238,84,93,30,199,229,48,46,25,40,151,815
C.J. Watson,PG,32,ORL,62,9,1012,96,248,32,105,64,143,57,66,16,73,89,114,43,2,47,84,281
C.J. Wilcox,SG,26,ORL,22,0,108,8,31,3,15,5,16,2,2,4,8,12,12,2,1,6,8,21
Cameron Payne,PG,22,TOT,31,0,462,64,193,27,86,37,107,5,8,3,45,48,55,14,4,29,52,160
Caris LeVert,SF,22,BRK,57,26,1237,171,380,59,184,112,196,67,93,23,165,188,110,49,8,59,91,468
Carmelo Anthony,SF,32,NYK,74,74,2538,602,1389,151,421,451,968,304,365,62,376,438,213,60,34,153,198,1659
Chandler Parsons,SF,28,MEM,34,34,675,75,222,25,93,50,129,35,43,6,78,84,55,20,5,24,52,210
Channing Frye,C,33,CLE,74,15,1398,238,520,137,335,101,185,63,74,37,253,290,45,33,37,53,138,676
Chasson Randle,PG,23,TOT,26,0,299,40,98,16,47,24,51,41,43,6,26,32,34,9,2,19,39,137
Cheick Diallo,PF,20,NOP,17,0,199,36,76,0,0,36,76,15,21,23,50,73,4,4,7,7,17,87
Chinanu Onuaku,C,20,HOU,5,1,52,5,7,0,0,5,7,4,4,2,8,10,3,3,1,4,6,14
Chris Andersen,C,38,CLE,12,0,114,9,22,0,3,9,19,10,14,9,22,31,5,5,7,5,20,28
Chris McCullough,PF,21,TOT,16,0,80,16,32,1,7,15,25,3,5,9,10,19,2,2,2,3,7,36
Chris Paul,PG,31,LAC,61,61,1921,374,785,124,302,250,483,232,260,40,264,304,563,119,8,147,146,1104
Christian Wood,PF,21,CHO,13,0,107,12,23,0,5,12,18,11,15,14,15,29,2,3,6,7,11,35
Clint Capela,C,22,HOU,65,59,1551,362,563,0,0,362,563,94,177,178,348,526,63,34,79,87,179,818
Cody Zeller,C,24,CHO,62,58,1725,253,443,0,1,253,442,133,196,135,270,405,99,62,58,65,189,639
Cole Aldrich,C,28,MIN,62,0,531,45,86,0,0,45,86,15,22,51,107,158,25,25,23,17,85,105
Corey Brewer,SF,30,TOT,82,11,1281,147,348,27,118,120,230,50,68,32,134,166,97,61,20,55,133,371
Cory Joseph,PG,25,TOR,80,22,2003,299,661,48,135,251,526,94,122,51,184,235,265,66,13,108,140,740
Courtney Lee,SG,31,NYK,77,74,2459,321,704,108,269,213,435,85,98,53,206,259,179,81,24,69,141,835
Cristiano Felicio,C,24,CHI,66,0,1040,128,221,0,0,128,221,60,93,124,187,311,40,25,17,33,110,316
D.J. Augustin,PG,29,ORL,78,20,1538,195,517,95,274,100,243,131,161,15,102,117,209,31,1,90,101,616
D'Angelo Russell,PG,20,LAL,63,60,1811,351,867,135,384,216,483,147,188,31,190,221,303,87,16,176,130,984
Dahntay Jones,SF,36,CLE,1,0,12,3,8,0,2,3,6,3,4,1,1,2,1,0,0,1,1,9
Damian Jones,C,21,GSW,10,0,85,8,16,0,0,8,16,3,10,9,14,23,0,1,4,6,15,19
Damian Lillard,PG,26,POR,75,75,2694,661,1488,214,579,447,909,488,545,46,322,368,440,68,20,197,152,2024
Damjan Rudez,SF,30,ORL,45,0,314,31,88,20,64,11,24,0,0,5,20,25,20,12,1,9,31,82
Daniel Ochefu,C,23,WAS,19,0,75,12,27,0,0,12,27,0,2,5,17,22,3,2,0,3,17,24
Danilo Gallinari,SF,28,DEN,63,63,2134,335,750,126,324,209,426,349,387,39,286,325,135,40,15,82,93,1145
Danny Green,SG,29,SAS,68,68,1807,176,449,118,311,58,138,27,32,31,193,224,124,70,57,76,120,497
Dante Cunningham,PF,29,NOP,66,35,1649,174,359,71,181,103,178,16,27,56,221,277,37,39,28,28,100,435
Dante Exum,PG,21,UTA,66,26,1228,155,363,44,149,111,214,58,73,30,102,132,111,21,12,80,146,412
Danuel House,SG,23,WAS,1,0,1,0,0,0,0,0,0,0,0,0,1,1,0,0,0,0,0,0
Dario Saric,PF,22,PHI,81,36,2129,381,927,106,341,275,586,172,220,112,401,513,182,57,30,183,162,1040
Darrell Arthur,PF,28,DEN,41,7,639,95,215,53,117,42,98,19,22,25,87,112,42,19,21,36,76,262
Darren Collison,PG,29,SAC,68,64,2063,340,714,73,175,267,539,147,171,23,129,152,312,67,9,114,119,900
Darrun Hilliard,SG,23,DET,39,1,381,47,126,12,46,35,80,21,28,2,31,33,33,11,2,28,39,127
David Lee,PF,33,SAS,79,10,1477,248,420,0,0,248,420,80,113,149,292,441,124,31,40,82,125,576
David Nwaba,SG,24,LAL,20,2,397,47,81,1,5,46,76,25,39,17,46,63,14,13,7,11,36,120
David West,C,36,GSW,68,0,854,135,252,3,8,132,244,43,56,47,156,203,151,42,48,78,105,316
Davis Bertans,PF,24,SAS,67,6,808,103,234,69,173,34,61,28,34,22,76,98,46,20,28,32,75,303
DeAndre Jordan,C,28,LAC,81,81,2570,412,577,0,2,412,575,205,425,298,816,1114,96,51,134,115,212,1029
DeAndre Liggins,SG,28,TOT,62,19,777,55,142,17,46,38,96,25,40,20,88,108,54,47,14,42,81,152
DeAndre' Bembry,SF,22,ATL,38,1,371,47,98,1,18,46,80,6,16,14,45,59,28,8,5,16,21,101
Dejounte Murray,PG,20,SAS,38,8,322,50,116,9,23,41,93,21,30,6,36,42,48,8,6,38,29,130
Delon Wright,PG,24,TOR,27,0,446,49,116,10,30,39,86,42,55,16,32,48,57,27,11,25,31,150
DeMar DeRozan,SG,27,TOR,74,74,2620,721,1545,33,124,688,1421,545,647,70,316,386,290,78,13,180,134,2020
DeMarcus Cousins,C,26,TOT,72,72,2465,647,1432,131,363,516,1069,517,670,152,642,794,332,100,93,269,278,1942
DeMarre Carroll,SF,30,TOR,72,72,1882,220,550,109,320,111,230,89,117,63,212,275,74,81,27,54,143,638
Demetrius Jackson,PG,22,BOS,5,0,17,3,4,1,1,2,3,3,6,2,2,4,3,0,0,0,0,10
Dennis Schroder,PG,23,ATL,79,78,2485,548,1214,100,294,448,920,218,255,42,206,248,499,74,16,258,149,1414
Denzel Valentine,SG,23,CHI,57,0,976,102,288,73,208,29,80,14,18,11,140,151,63,30,7,49,86,291
Deron Williams,PG,32,TOT,64,44,1657,263,600,85,234,178,366,90,109,14,133,147,360,31,8,138,138,701
Derrick Favors,PF,25,UTA,50,39,1186,203,417,3,10,200,407,67,109,92,213,305,56,45,40,60,103,476
Derrick Jones,SF,19,PHO,32,8,545,68,121,3,11,65,110,29,41,39,40,79,12,14,13,13,63,168
Derrick Rose,PG,28,NYK,64,64,2082,460,977,13,60,447,917,221,253,66,180,246,283,44,17,147,84,1154
Derrick Williams,PF,25,TOT,50,11,804,108,244,30,97,78,147,58,89,19,111,130,28,14,7,28,60,304
Devin Booker,SG,20,PHO,78,78,2730,606,1431,147,405,459,1026,367,441,46,203,249,268,72,21,241,242,1726
Devin Harris,PG,33,DAL,65,0,1087,136,341,58,177,78,164,107,129,11,116,127,136,43,7,57,101,437
Dewayne Dedmon,C,27,SAS,76,37,1330,161,259,0,0,161,259,65,93,129,367,496,44,37,61,61,180,387
Deyonta Davis,C,20,MEM,36,0,238,24,47,0,0,24,47,10,18,20,40,60,2,3,17,8,40,58
Diamond Stone,C,19,LAC,7,0,24,3,13,0,0,3,13,4,4,1,5,6,0,0,1,2,5,10
Dion Waiters,SG,25,MIA,46,43,1384,281,663,85,215,196,448,82,127,18,135,153,200,42,20,103,95,729
Dirk Nowitzki,PF,38,DAL,54,54,1424,296,678,79,209,217,469,98,112,23,330,353,82,30,38,51,113,769
Domantas Sabonis,PF,20,OKC,81,66,1632,192,481,51,159,141,322,44,67,46,242,288,82,39,32,83,200,479
Donatas Motiejunas,PF,26,NOP,34,0,479,57,138,11,47,46,91,25,49,26,75,101,32,18,11,31,55,150
Dorian Finney-Smith,PF,23,DAL,81,35,1642,124,333,56,191,68,142,46,61,55,167,222,67,52,25,45,125,350
Doug McDermott,SF,25,TOT,66,5,1508,222,497,77,208,145,289,71,84,20,159,179,58,13,5,38,79,592
Dragan Bender,PF,19,PHO,43,0,574,57,161,28,101,29,60,4,11,23,80,103,23,10,22,32,74,146
Draymond Green,PF,26,GSW,76,76,2471,272,650,81,263,191,387,151,213,98,501,599,533,154,106,184,217,776
Dwight Howard,C,31,ATL,74,74,2199,388,613,0,2,388,611,226,424,296,644,940,104,64,92,170,203,1002
Dwight Powell,C,25,DAL,77,3,1333,194,377,21,74,173,303,107,141,93,213,306,49,61,39,34,135,516
Dwyane Wade,SG,35,CHI,60,59,1792,414,955,45,145,369,810,223,281,63,207,270,228,86,41,138,112,1096
E'Twaun Moore,SG,27,NOP,73,22,1820,283,619,77,208,206,411,57,74,33,119,152,164,50,32,62,131,700
Ed Davis,PF,27,POR,46,12,789,75,142,0,0,75,142,50,81,96,148,244,26,15,22,37,137,200
Edy Tavares,C,24,TOT,2,0,28,4,5,0,0,4,5,0,3,4,7,11,1,0,6,2,3,8
Elfrid Payton,PG,22,ORL,82,58,2412,430,912,40,146,390,766,146,211,89,298,387,529,88,40,178,177,1046
Elijah Millsap,SG,29,PHO,2,0,23,1,7,0,2,1,5,1,2,3,3,6,1,0,0,2,2,3
Emmanuel Mudiay,PG,20,DEN,55,41,1406,208,551,56,178,152,373,131,167,29,149,178,217,41,13,123,95,603
Enes Kanter,C,24,OKC,72,0,1533,402,737,5,38,397,699,224,285,195,287,482,67,32,38,123,154,1033
Eric Bledsoe,PG,27,PHO,66,66,2176,449,1034,104,310,345,724,388,458,52,268,320,418,91,31,224,164,1390
Eric Gordon,SG,28,HOU,75,15,2323,412,1016,246,661,166,355,147,175,29,172,201,188,48,41,121,150,1217
Ersan Ilyasova,PF,29,TOT,82,52,2142,384,890,142,402,242,488,161,207,115,366,481,141,58,23,116,211,1071
Evan Fournier,SG,24,ORL,68,66,2234,408,930,128,360,280,570,223,277,44,165,209,202,66,4,141,180,1167
Evan Turner,SF,28,POR,65,12,1658,235,552,31,118,204,434,85,103,36,211,247,205,53,24,100,121,586
Frank Kaminsky,C,23,CHO,75,16,1954,320,802,116,354,204,448,118,156,57,279,336,162,46,34,76,139,874
Fred VanVleet,PG,22,TOR,37,0,294,39,111,11,29,28,82,18,22,4,38,42,35,16,3,15,36,107
Garrett Temple,SG,30,SAC,65,21,1728,183,432,82,220,101,212,58,74,32,152,184,168,84,28,78,141,506
Gary Harris,SG,22,DEN,57,56,1782,320,637,107,255,213,382,104,134,48,130,178,164,71,8,76,92,851
Gary Neal,SG,32,ATL,2,0,18,0,7,0,2,0,5,4,4,0,1,1,1,0,0,0,1,4
Gary Payton,PG,24,MIL,6,0,99,8,22,1,9,7,13,3,5,0,12,12,13,3,4,10,9,20
George Hill,PG,30,UTA,49,49,1544,289,606,94,233,195,373,157,196,23,144,167,204,50,11,85,114,829
Georges Niang,PF,23,IND,23,0,93,9,36,1,12,8,24,2,2,2,15,17,5,3,0,5,6,21
Georgios Papagiannis,C,19,SAC,22,0,355,56,102,0,2,56,100,12,14,24,62,86,20,3,17,24,44,124
Gerald Green,SF,31,BOS,47,0,538,95,232,39,111,56,121,33,41,16,68,84,33,9,7,25,48,262
Gerald Henderson,SG,29,PHI,72,41,1667,234,553,61,173,173,380,133,165,34,151,185,112,40,15,62,129,662
Giannis Antetokounmpo,SF,22,MIL,80,80,2845,656,1259,49,180,607,1079,471,612,142,558,700,434,131,151,234,246,1832
Glenn Robinson,SF,23,IND,69,27,1427,158,338,49,125,109,213,54,76,57,189,246,47,41,20,37,63,419
Goran Dragic,PG,30,MIA,73,73,2459,534,1124,117,289,417,835,298,377,62,217,279,423,89,13,212,199,1483
Gordon Hayward,SF,26,UTA,73,73,2516,545,1156,149,374,396,782,362,429,49,345,394,252,73,20,140,117,1601
Gorgui Dieng,PF,27,MIN,82,82,2653,332,661,16,43,316,618,136,167,188,459,647,158,88,95,107,254,816
Greg Monroe,C,26,MIL,81,0,1823,387,726,0,4,387,722,177,239,167,365,532,187,92,38,140,168,951
Greivis Vasquez,PG,30,BRK,3,0,39,2,8,1,3,1,5,2,3,0,2,2,5,1,1,1,6,7
Harrison Barnes,PF,24,DAL,79,79,2803,599,1280,78,222,521,1058,242,281,93,301,394,116,65,15,102,128,1518
Hassan Whiteside,C,27,MIA,77,77,2513,542,973,0,0,542,973,225,358,293,795,1088,57,57,161,154,226,1309
Henry Ellenson,PF,20,DET,19,2,146,23,64,10,35,13,29,4,8,8,33,41,7,1,1,14,6,60
Hollis Thompson,SG,25,TOT,40,9,752,77,200,32,95,45,105,19,29,19,93,112,35,20,6,11,69,205
Ian Clark,SG,25,GSW,77,0,1137,211,433,61,163,150,270,44,58,22,99,121,90,39,8,55,77,527
Ian Mahinmi,C,30,WAS,31,0,555,65,111,0,0,65,111,43,75,47,103,150,19,33,24,34,90,173
Iman Shumpert,SG,26,CLE,76,31,1937,201,489,94,261,107,228,71,90,39,179,218,109,62,27,78,150,567
Isaiah Canaan,SG,25,CHI,39,0,592,63,173,25,94,38,79,30,33,6,44,50,37,22,1,21,35,181
Isaiah Taylor,PG,22,HOU,4,0,52,1,7,0,2,1,5,1,2,1,2,3,3,1,1,0,6,3
Isaiah Thomas,PG,27,BOS,76,76,2569,682,1473,245,646,437,827,590,649,43,162,205,448,70,13,210,167,2199
Isaiah Whitehead,PG,21,BRK,73,26,1643,204,508,44,149,160,359,91,113,32,152,184,192,42,36,142,175,543
Ish Smith,PG,28,DET,81,32,1955,329,749,28,105,301,644,72,102,21,214,235,418,61,33,112,127,758
Ivica Zubac,C,19,LAL,38,11,609,126,238,0,3,126,235,32,49,41,118,159,30,14,33,30,66,284
J.J. Barea,PG,32,DAL,35,6,771,142,343,53,148,89,195,44,51,9,75,84,193,14,1,63,30,381
J.J. Redick,SG,32,LAC,78,78,2198,396,890,201,468,195,422,180,202,11,160,171,110,54,13,98,125,1173
J.R. Smith,SG,31,CLE,41,35,1187,123,356,95,271,28,85,10,15,17,96,113,62,40,11,26,77,351
Jabari Parker,PF,21,MIL,51,50,1728,399,814,65,178,334,636,162,218,79,235,314,142,50,22,93,111,1025
Jae Crowder,SF,26,BOS,72,72,2335,333,720,157,394,176,326,176,217,48,367,415,155,73,23,80,161,999
Jahlil Okafor,C,21,PHI,50,33,1134,242,471,0,0,242,471,106,158,81,159,240,58,20,49,91,122,590
Jake Layman,SF,22,POR,35,1,249,26,89,13,51,13,38,13,17,6,18,24,11,9,3,11,22,78
Jakob Poeltl,C,21,TOR,54,4,626,67,115,0,0,67,115,31,57,78,87,165,12,17,20,29,113,165
Jamal Crawford,SG,36,LAC,82,1,2157,359,870,116,322,243,548,174,203,17,112,129,214,61,14,134,115,1008
Jamal Murray,SG,19,DEN,82,10,1764,295,730,115,344,180,386,106,120,41,173,214,170,51,24,113,124,811
Jameer Nelson,PG,34,DEN,75,39,2045,268,604,106,273,162,331,45,63,28,164,192,385,54,8,128,197,687
James Ennis,SF,26,MEM,64,28,1501,146,321,51,137,95,184,86,110,69,190,259,64,46,19,59,165,429
James Harden,PG,27,HOU,81,81,2947,674,1533,262,756,412,777,746,881,95,564,659,907,121,38,464,215,2356
James Johnson,PF,29,MIA,76,5,2085,368,769,87,256,281,513,152,215,66,310,376,276,76,86,171,197,975
James Jones,SF,36,CLE,48,2,381,44,92,31,66,13,26,13,20,3,34,37,14,6,10,10,37,132
James Michael McAdoo,PF,24,GSW,52,2,457,62,117,2,8,60,109,21,42,34,57,91,18,18,29,19,47,147
James Young,SG,21,BOS,29,0,220,25,58,12,35,13,23,6,9,6,20,26,4,10,2,4,15,68
JaMychal Green,PF,26,MEM,77,75,2101,250,500,55,145,195,355,134,167,167,377,544,84,47,34,94,248,689
Jared Dudley,PF,31,PHO,64,7,1362,157,346,77,203,80,143,43,65,31,194,225,121,42,16,73,154,434
Jared Sullinger,PF,24,TOR,11,1,118,15,47,3,18,12,29,4,8,10,17,27,3,4,1,4,17,37
Jarell Eddie,SF,25,PHO,5,0,62,6,19,4,16,2,3,8,9,1,6,7,0,1,0,1,1,24
Jarell Martin,PF,22,MEM,42,3,558,58,151,9,25,49,126,40,50,42,120,162,8,17,9,28,91,165
Jarnell Stokes,C,23,DEN,2,0,7,1,1,0,0,1,1,1,2,1,1,2,2,1,0,0,3,3
Jarrett Jack,PG,33,NOP,2,0,33,2,3,0,1,2,2,2,2,0,0,0,5,2,0,3,4,6
Jarrod Uthoff,PF,23,DAL,9,0,115,16,38,3,9,13,29,5,7,8,14,22,9,2,4,3,8,40
Jason Smith,C,30,WAS,74,3,1068,174,329,37,78,137,251,35,51,64,194,258,37,21,54,58,168,420
Jason Terry,SG,39,MIL,74,0,1365,105,243,73,171,32,72,24,29,15,91,106,98,46,20,36,95,307
JaVale McGee,C,29,GSW,77,10,739,208,319,0,3,208,316,56,111,100,144,244,17,19,67,40,109,472
Jaylen Brown,SF,20,BOS,78,20,1341,192,423,46,135,146,288,85,124,45,175,220,64,35,18,68,142,515
Jeff Green,PF,30,ORL,69,11,1534,220,558,53,193,167,365,145,168,39,175,214,81,37,13,75,103,638
Jeff Teague,PG,28,IND,82,82,2657,402,909,90,252,312,657,360,415,33,297,330,639,100,32,216,165,1254
Jeff Withey,C,26,UTA,51,1,432,55,103,0,1,55,102,36,48,52,69,121,7,16,32,14,52,146
Jerami Grant,PF,22,TOT,80,4,1531,152,328,43,116,109,212,90,147,38,167,205,46,33,79,44,149,437
Jeremy Lamb,SG,24,CHO,62,5,1143,226,491,41,146,185,345,110,129,30,234,264,75,27,23,40,98,603
Jeremy Lin,PG,28,BRK,36,33,883,175,400,58,156,117,244,115,141,11,124,135,184,42,14,86,79,523
Jerian Grant,PG,24,CHI,63,28,1028,128,301,49,134,79,167,65,73,17,94,111,121,47,8,44,93,370
Jerryd Bayless,PG,28,PHI,3,1,71,11,32,2,5,9,27,9,10,3,9,12,13,0,0,9,4,33
Jimmy Butler,SF,27,CHI,76,75,2809,570,1252,91,248,479,1004,585,676,129,341,470,417,143,32,159,112,1816
Joakim Noah,C,31,NYK,46,46,1015,99,202,0,1,99,201,34,78,162,241,403,103,30,37,58,127,232
Jodie Meeks,SG,29,ORL,36,10,738,103,256,56,137,47,119,65,74,5,72,77,45,34,4,36,41,327
Joe Harris,SG,25,BRK,52,11,1138,154,362,85,221,69,141,35,49,16,131,147,54,30,8,55,121,428
Joe Ingles,SF,29,UTA,82,26,1972,204,451,123,279,81,172,50,68,23,238,261,225,96,8,107,163,581
Joe Johnson,SF,35,UTA,78,14,1843,273,626,106,258,167,368,63,77,33,210,243,144,36,18,69,93,715
Joe Young,PG,24,IND,33,0,135,26,72,5,23,21,49,11,15,1,16,17,15,4,0,5,5,68
Joel Anthony,C,34,SAS,19,0,122,10,16,0,0,10,16,5,8,8,23,31,3,2,6,4,11,25
Joel Bolomboy,PF,23,UTA,12,0,53,9,16,1,4,8,12,3,6,4,13,17,2,1,2,2,1,22
Joel Embiid,C,22,PHI,31,31,786,200,429,36,98,164,331,191,244,61,182,243,66,27,76,117,112,627
Joffrey Lauvergne,PF-C,25,TOT,70,1,980,148,336,33,98,115,238,46,73,72,179,251,70,25,6,56,83,375
John Henson,C,26,MIL,58,39,1123,159,309,0,1,159,308,74,107,92,203,295,57,29,78,52,151,392
John Jenkins,SG,25,PHO,4,0,13,2,5,1,2,1,3,2,2,0,1,1,1,0,0,0,0,7
John Lucas III,PG,34,MIN,5,0,11,1,4,0,1,1,3,0,0,0,0,0,1,2,0,0,0,2
John Wall,PG,26,WAS,78,78,2836,647,1435,89,272,558,1163,422,527,59,267,326,831,157,49,322,151,1805
Johnny O'Bryant,PF,23,TOT,11,0,80,15,30,3,6,12,24,5,6,9,10,19,6,0,1,6,10,38
Jon Leuer,PF,27,DET,75,34,1944,310,646,49,167,261,479,98,113,102,300,402,111,31,26,66,145,767
Jonas Jerebko,PF,29,BOS,78,6,1232,114,262,45,130,69,132,26,37,59,213,272,71,25,17,39,122,299
Jonas Valanciunas,C,24,TOR,80,80,2066,391,702,1,2,390,700,176,217,226,533,759,57,37,63,106,216,959
Jonathan Gibson,PG,29,DAL,17,0,231,35,95,15,45,20,50,21,29,1,21,22,26,8,0,21,21,106
Jonathon Simmons,SG,27,SAS,78,8,1392,177,421,30,102,147,319,99,132,20,140,160,126,47,25,76,146,483
Jordan Clarkson,SG,24,LAL,82,19,2397,477,1071,117,356,360,715,134,168,49,197,246,213,88,8,164,150,1205
Jordan Crawford,SG,28,NOP,19,0,442,105,218,37,95,68,123,20,26,4,30,34,57,11,2,25,30,267
Jordan Farmar,PG,30,SAC,2,0,35,4,12,4,9,0,3,0,0,1,2,3,9,2,0,3,1,12
Jordan Hill,C,29,MIN,7,0,47,5,13,0,0,5,13,2,2,8,6,14,0,1,0,4,9,12
Jordan McRae,SG,25,CLE,37,4,384,58,150,18,51,40,99,27,34,6,35,41,19,8,6,14,31,161
Jordan Mickey,PF,22,BOS,25,1,141,15,34,0,1,15,33,8,14,13,21,34,7,3,6,9,12,38
Jose Calderon,PG,35,TOT,41,13,539,55,134,20,64,35,70,11,12,15,59,74,88,11,1,41,36,141
Josh Huestis,PF,25,OKC,2,0,31,6,11,2,4,4,7,0,1,4,5,9,3,0,3,0,0,14
Josh McRoberts,PF,29,MIA,22,14,381,44,118,13,31,31,87,6,9,23,51,74,50,10,4,23,31,107
Josh Richardson,SG,23,MIA,53,34,1614,202,513,75,227,127,286,60,77,35,133,168,140,60,39,65,132,539
Jrue Holiday,PG,26,NOP,67,61,2190,405,893,100,281,305,612,119,168,46,218,264,488,100,44,194,133,1029
Juan Hernangomez,PF,21,DEN,62,9,842,101,224,46,113,55,111,57,76,43,144,187,29,30,12,31,62,305
Julius Randle,PF,22,LAL,74,73,2132,377,773,17,63,360,710,204,282,150,486,636,264,49,37,173,248,975
Justin Anderson,SF,23,TOT,75,10,1228,186,439,58,194,128,245,102,129,69,176,245,66,41,23,66,109,532
Justin Hamilton,C,26,BRK,64,7,1177,174,379,55,180,119,199,39,52,71,191,262,55,29,43,43,91,442
Justin Harper,PF,27,PHI,3,0,31,5,12,2,7,3,5,0,0,2,3,5,2,0,0,4,2,12
Justin Holiday,SG,27,NYK,82,4,1639,233,538,97,273,136,265,66,80,27,198,225,102,65,31,66,109,629
Justise Winslow,SF,20,MIA,18,15,625,80,225,7,35,73,190,29,47,23,71,94,66,26,6,33,52,196
Jusuf Nurkic,C,22,TOT,65,48,1391,271,534,0,1,271,533,120,210,154,313,467,123,50,74,143,161,662
K.J. McDaniels,SF,23,TOT,49,0,505,77,169,20,66,57,103,32,38,15,67,82,13,19,18,29,49,206
Karl-Anthony Towns,C,21,MIN,82,82,3030,802,1480,101,275,701,1205,356,428,296,711,1007,220,56,103,212,241,2061
Kawhi Leonard,SF,25,SAS,74,74,2474,636,1312,147,387,489,925,469,533,80,350,430,260,133,55,154,122,1888
Kay Felder,PG,21,CLE,42,0,386,62,158,7,22,55,136,35,49,3,38,41,58,18,7,30,38,166
Kelly Olynyk,C,25,BOS,75,6,1538,260,508,68,192,192,316,90,123,73,288,361,148,43,29,96,207,678
Kelly Oubre,SF,21,WAS,79,5,1605,186,442,54,188,132,254,75,99,61,200,261,47,58,17,50,195,501
Kemba Walker,PG,26,CHO,79,79,2739,643,1449,240,602,403,847,304,359,45,263,308,434,85,22,168,119,1830
Kenneth Faried,PF,27,DEN,61,34,1296,228,416,0,6,228,410,131,189,183,279,462,55,43,40,59,124,587
Kent Bazemore,SF,27,ATL,73,64,1963,295,721,92,266,203,455,119,168,45,186,231,177,91,52,125,165,801
Kentavious Caldwell-Pope,SG,23,DET,76,75,2529,370,928,153,437,217,491,154,185,55,193,248,193,89,12,86,118,1047
Kevin Durant,PF,28,GSW,62,62,2070,551,1026,117,312,434,714,336,384,39,474,513,300,66,99,138,117,1555
Kevin Love,PF,28,CLE,60,60,1885,370,867,145,389,225,478,257,295,148,518,666,116,53,21,122,125,1142
Kevin Seraphin,PF,27,IND,49,3,559,109,198,0,2,109,196,14,22,41,101,142,23,7,20,29,66,232
Kevon Looney,C,20,GSW,53,4,447,56,107,2,9,54,98,21,34,44,80,124,29,15,17,17,64,135
Khris Middleton,SF,25,MIL,29,23,889,150,333,45,104,105,229,81,92,11,112,123,99,41,7,65,79,426
Klay Thompson,SG,26,GSW,78,78,2649,644,1376,268,647,376,729,186,218,49,236,285,160,66,40,128,139,1742
Kosta Koufos,C,27,SAC,71,62,1419,216,392,0,1,216,391,38,62,118,285,403,47,36,48,61,172,470
Kris Dunn,PG,22,MIN,78,7,1333,118,313,21,73,97,240,36,59,24,142,166,188,78,36,89,178,293
Kris Humphries,PF,31,ATL,56,4,689,87,214,19,54,68,160,64,82,60,146,206,29,15,21,28,69,257
Kristaps Porzingis,PF,21,NYK,66,65,2164,443,985,112,314,331,671,198,252,111,364,475,97,47,129,118,244,1196
Kyle Anderson,SF,23,SAS,72,14,1020,93,209,15,40,78,169,45,57,33,175,208,91,51,26,39,63,246
Kyle Korver,SG,35,TOT,67,22,1753,239,515,162,359,77,156,38,42,7,179,186,110,34,21,69,107,678
Kyle Lowry,PG,30,TOR,60,60,2244,426,918,193,468,233,450,299,365,48,238,286,417,88,19,173,170,1344
Kyle O'Quinn,C,26,NYK,79,8,1229,215,413,2,17,213,396,64,83,157,282,439,117,36,104,76,174,496
Kyle Singler,SF,28,OKC,32,2,385,34,83,7,37,27,46,13,17,8,40,48,9,7,5,11,29,88
Kyle Wiltjer,PF,24,HOU,14,0,44,4,14,4,13,0,1,1,2,4,6,10,2,3,1,5,4,13
Kyrie Irving,PG,24,CLE,72,72,2525,671,1420,177,441,494,979,297,328,52,178,230,418,83,24,180,157,1816
Lamar Patterson,SG,25,ATL,5,0,40,3,15,1,6,2,9,2,3,1,6,7,6,1,0,4,6,9
LaMarcus Aldridge,PF,31,SAS,72,72,2335,500,1049,23,56,477,993,220,271,172,351,523,139,46,88,98,158,1243
Lance Stephenson,SG,26,TOT,18,0,361,54,120,6,20,48,100,8,13,4,48,52,59,5,3,26,32,122
Lance Thomas,PF,28,NYK,46,15,968,97,244,38,85,59,159,43,51,32,110,142,35,21,5,25,85,275
Langston Galloway,PG,25,TOT,74,2,1495,207,545,120,308,87,237,51,64,27,129,156,93,46,6,46,96,585
Larry Nance,PF,24,LAL,63,7,1442,190,361,10,36,180,325,59,80,120,249,369,96,82,39,56,149,449
Larry Sanders,C,28,CLE,5,0,13,1,4,0,0,1,4,2,2,3,1,4,0,1,1,2,5,4
Lavoy Allen,PF,27,IND,61,5,871,77,168,0,1,77,167,23,33,105,114,219,57,18,24,29,78,177
Leandro Barbosa,SG,34,PHO,67,0,963,172,392,35,98,137,294,40,45,15,89,104,81,31,8,48,82,419
LeBron James,SF,32,CLE,74,74,2794,736,1344,124,342,612,1002,358,531,97,542,639,646,92,44,303,134,1954
Lou Williams,SG,30,TOT,81,1,1994,428,998,163,446,265,552,402,457,26,176,202,239,80,20,160,92,1421
Luc Mbah a Moute,SF,30,LAC,80,76,1787,191,378,43,110,148,268,59,87,44,126,170,39,81,35,46,122,484
Lucas Nogueira,C,24,TOR,57,6,1088,103,156,3,12,100,144,44,67,82,162,244,42,52,89,46,137,253
Luis Scola,PF,36,BRK,36,1,461,71,151,17,50,54,101,25,37,51,88,139,37,14,4,34,63,184
Luke Babbitt,SF,27,MIA,68,55,1065,113,281,87,210,26,71,11,15,12,129,141,36,20,11,25,118,324
Luol Deng,SF,31,LAL,56,49,1486,164,424,51,165,113,259,46,63,63,232,295,74,48,20,43,61,425
Malachi Richardson,SG,21,SAC,22,0,198,28,68,8,28,20,40,15,19,3,20,23,11,5,1,8,23,79
Malcolm Brogdon,SG,24,MIL,75,28,1982,290,635,78,193,212,442,109,126,47,166,213,317,84,12,113,140,767
Malcolm Delaney,PG,27,ATL,73,2,1248,145,388,26,110,119,278,75,93,10,113,123,193,39,1,95,112,391
Malik Beasley,SG,20,DEN,22,1,165,33,73,9,28,24,45,8,10,5,12,17,11,7,0,8,10,83
Manny Harris,SG,27,DAL,4,0,25,3,15,0,2,3,13,2,4,3,6,9,2,0,0,2,1,8
Manu Ginobili,SG,39,SAS,69,0,1291,171,439,89,227,82,212,86,107,28,129,157,183,82,16,96,119,517
Marc Gasol,C,32,MEM,74,74,2531,532,1160,104,268,428,892,278,332,60,404,464,338,67,99,166,171,1446
Marcelo Huertas,PG,33,LAL,23,1,237,25,68,4,19,21,49,9,17,2,22,24,52,10,2,19,16,63
Marcin Gortat,C,32,WAS,82,82,2556,390,674,0,2,390,672,103,159,238,611,849,121,40,61,119,213,883
Marco Belinelli,SG,30,CHO,74,0,1778,264,615,102,283,162,332,150,168,14,164,178,147,44,9,70,90,780
Marcus Georges-Hunt,SG,22,ORL,5,0,48,2,7,1,2,1,5,9,10,1,8,9,3,1,0,2,5,14
Marcus Morris,SF,27,DET,79,79,2565,421,1007,118,357,303,650,145,185,77,289,366,160,52,25,87,168,1105
Marcus Smart,SG,22,BOS,79,24,2399,269,749,94,332,175,417,203,250,78,227,305,364,125,34,159,192,835
Marcus Thornton,SG,29,WAS,33,1,575,84,210,28,80,56,130,23,27,22,54,76,41,19,3,25,48,219
Mario Hezonja,SF,21,ORL,65,2,960,117,330,43,144,74,186,40,50,20,126,146,62,30,15,58,74,317
Markieff Morris,PF,27,WAS,76,76,2374,406,889,71,196,335,693,180,215,107,386,493,126,82,42,129,254,1063
Marquese Chriss,PF,19,PHO,82,75,1743,284,632,72,224,212,408,113,181,96,252,348,60,67,70,108,263,753
Marreese Speights,C,29,LAC,82,2,1286,244,548,103,277,141,271,120,137,88,285,373,65,23,41,69,229,711
Marshall Plumlee,C,24,NYK,21,1,170,16,30,0,0,16,30,8,19,23,28,51,10,4,4,12,23,40
Marvin Williams,PF,30,CHO,76,76,2295,297,704,124,354,173,350,131,150,89,411,500,106,58,53,60,134,849
Mason Plumlee,C,26,TOT,81,64,2148,334,623,0,6,334,617,174,300,170,435,605,284,69,92,134,226,842
Matt Barnes,SF,36,TOT,74,18,1777,185,473,87,263,98,210,70,89,70,314,384,195,48,26,107,185,527
Matthew Dellavedova,PG,26,MIL,76,54,1986,208,534,79,215,129,319,82,96,24,123,147,357,53,0,133,153,577
Maurice Harkless,SF,23,POR,77,69,2223,314,624,68,194,246,430,77,124,125,216,341,88,85,70,86,214,773
Maurice Ndour,PF,24,NYK,32,4,331,39,86,1,7,38,79,19,26,22,42,64,8,15,8,12,30,98
Metta World Peace,SF,37,LAL,25,2,160,19,68,9,38,10,30,10,16,5,15,20,11,10,2,7,18,57
Meyers Leonard,PF,24,POR,74,12,1222,146,378,74,213,72,165,35,40,27,210,237,71,13,28,35,172,401
Michael Beasley,PF,28,MIL,56,6,935,216,406,18,43,198,363,78,105,40,153,193,53,27,27,66,92,528
Michael Carter-Williams,PG,25,CHI,45,19,846,112,306,15,64,97,242,58,77,24,129,153,113,38,23,66,102,297
Michael Gbinije,SG,24,DET,9,0,32,1,10,0,4,1,6,2,2,2,1,3,2,0,0,0,2,4
Michael Kidd-Gilchrist,SF,23,CHO,81,81,2349,295,618,1,9,294,609,152,194,156,409,565,114,81,77,56,187,743
Mike Conley,PG,29,MEM,69,68,2292,464,1009,171,419,293,590,316,368,31,210,241,433,92,19,156,126,1415
Mike Dunleavy,SF,36,TOT,53,2,841,93,220,53,134,40,86,36,45,18,97,115,50,15,7,28,67,275
Mike Miller,SF,36,DEN,20,0,151,9,23,8,20,1,3,2,2,2,36,38,22,2,0,13,9,28
Mike Muscala,C,25,ATL,70,3,1237,170,337,46,110,124,227,49,64,76,164,240,95,30,41,55,97,435
Mike Scott,PF,28,ATL,18,0,195,17,59,4,27,13,32,7,8,10,27,37,17,4,3,8,12,45
Mike Tobey,C,22,CHO,2,0,25,1,4,0,0,1,4,0,0,2,1,3,1,0,0,1,2,2
Miles Plumlee,C,28,TOT,45,12,484,44,92,0,0,44,92,25,39,38,57,95,21,18,13,30,73,113
Mindaugas Kuzminskas,SF,27,NYK,68,5,1016,158,369,54,168,104,201,55,68,47,79,126,69,29,11,51,79,425
Mirza Teletovic,PF,31,MIL,70,2,1133,156,418,104,305,52,113,35,45,11,151,162,48,12,13,37,109,451
Monta Ellis,SG,31,IND,74,33,1998,247,557,43,135,204,422,93,128,19,185,204,236,78,27,135,149,630
Montrezl Harrell,C,23,HOU,58,14,1064,225,345,1,7,224,338,76,121,81,138,219,64,20,42,44,126,527
Myles Turner,C,20,IND,81,81,2541,444,869,40,115,404,754,245,303,139,450,589,106,74,172,105,262,1173
Nemanja Bjelica,PF,28,MIN,65,1,1190,151,356,56,177,95,179,45,61,57,187,244,79,40,20,59,154,403
Nene Hilario,C,34,HOU,67,8,1198,245,397,3,9,242,388,116,197,95,187,282,65,56,39,73,163,609
Nerlens Noel,C,22,TOT,51,19,1047,184,309,0,1,184,308,77,111,93,201,294,50,65,50,51,126,445
Nick Collison,PF,36,OKC,20,0,128,14,23,0,1,14,22,5,8,9,22,31,12,2,2,4,17,33
Nick Young,SG,31,LAL,60,60,1556,272,633,170,421,102,212,77,90,25,113,138,58,37,14,36,137,791
Nicolas Batum,SG,28,CHO,77,77,2617,393,975,135,405,258,570,243,284,46,435,481,456,86,29,194,109,1164
Nicolas Brussino,SG,23,DAL,54,2,521,52,141,29,95,23,46,17,22,26,69,95,47,17,8,26,43,150
Nicolas Laprovittola,PG,27,SAS,18,3,174,20,47,10,27,10,20,9,9,1,9,10,28,4,1,19,19,59
Nik Stauskas,SG,23,PHI,80,27,2188,251,634,132,359,119,275,122,150,21,205,226,188,45,32,128,144,756
Nikola Jokic,C,21,DEN,73,59,2038,494,854,45,139,449,715,188,228,212,506,718,359,61,55,171,214,1221
Nikola Mirotic,PF,25,CHI,70,15,1679,258,625,129,377,129,248,99,128,61,323,384,75,53,55,80,128,744
Nikola Vucevic,C,26,ORL,75,55,2163,483,1031,23,75,460,956,107,160,176,603,779,208,76,74,117,180,1096
Noah Vonleh,PF,21,POR,74,41,1265,130,270,7,20,123,250,60,94,131,256,387,31,30,27,64,154,327
Norman Powell,SG,23,TOR,76,18,1368,227,506,56,173,171,333,126,159,26,143,169,82,52,14,70,127,636
Norris Cole,PG,28,OKC,13,0,125,16,52,3,13,13,39,8,10,0,11,11,14,8,0,7,18,43
Okaro White,PF,24,MIA,35,0,471,33,87,12,34,21,53,20,22,25,57,82,21,10,10,18,52,98
Omer Asik,C,30,NOP,31,19,482,31,65,0,0,31,65,23,39,48,115,163,15,5,10,14,51,85
Omri Casspi,PF,28,TOT,36,2,643,77,164,15,43,62,121,17,29,27,85,112,37,23,3,29,50,186
Otto Porter,SF,23,WAS,80,80,2605,414,803,148,341,266,462,99,119,118,396,514,121,116,42,44,193,1075
P.J. Tucker,SF,31,TOT,81,21,2236,199,482,70,196,129,286,72,93,117,354,471,99,116,19,66,196,540
Pascal Siakam,PF,22,TOR,55,38,859,103,205,1,7,102,198,22,32,64,121,185,17,26,45,33,109,229
Pat Connaughton,SG,24,POR,39,1,316,37,72,17,33,20,39,7,9,10,42,52,28,6,2,17,23,98
Patricio Garino,SG,23,ORL,5,0,43,0,7,0,5,0,2,0,0,1,6,7,0,0,0,3,4,0
Patrick Beverley,SG,28,HOU,67,67,2058,228,543,110,288,118,255,73,95,95,298,393,281,99,25,100,222,639
Patrick McCaw,SG,21,GSW,71,20,1074,106,245,41,123,65,122,29,37,21,79,100,77,32,15,36,62,282
Patrick Patterson,PF,27,TOR,65,8,1599,154,384,94,253,60,131,43,60,62,231,293,76,40,23,38,120,445
Patty Mills,PG,28,SAS,80,8,1754,273,621,147,355,126,266,66,80,24,117,141,280,65,3,101,109,759
Pau Gasol,C,36,SAS,64,39,1627,303,604,56,104,247,500,130,184,107,394,501,150,24,70,81,110,792
Paul George,SF,26,IND,75,75,2689,622,1348,195,496,427,852,336,374,58,434,492,251,119,27,220,206,1775
Paul Millsap,PF,31,ATL,69,67,2343,430,972,75,241,355,731,311,405,111,422,533,252,90,62,158,186,1246
Paul Pierce,SF,39,LAC,25,7,277,28,70,15,43,13,27,10,13,1,47,48,10,4,5,16,40,81
Paul Zipser,SF,22,CHI,44,18,843,88,221,33,99,55,122,31,40,15,110,125,36,15,16,40,78,240
Pierre Jackson,PG,25,DAL,8,1,84,13,39,3,11,10,28,6,7,1,8,9,19,2,0,3,5,35
Quincy Acy,PF,26,TOT,38,1,558,70,170,37,90,33,80,45,60,20,95,115,18,14,15,21,67,222
Quinn Cook,PG,23,TOT,14,0,188,33,66,11,26,22,40,2,5,1,6,7,26,4,0,13,13,79
R.J. Hunter,SG,23,CHI,3,0,9,0,1,0,1,0,0,0,0,0,1,1,0,0,0,0,0,0
Rajon Rondo,PG,30,CHI,69,42,1843,229,561,50,133,179,428,30,50,73,282,355,461,99,11,169,144,538
Rakeem Christmas,PF,25,IND,29,0,219,19,43,0,0,19,43,21,29,26,30,56,4,3,6,8,37,59
Ramon Sessions,PG,30,CHO,50,1,811,100,263,21,62,79,201,91,118,11,62,73,129,27,3,46,43,312
Randy Foye,SG,33,BRK,69,40,1284,118,325,67,203,51,122,54,63,9,146,155,135,35,9,80,99,357
Rashad Vaughn,SG,20,MIL,41,2,458,57,156,26,81,31,75,2,5,4,45,49,23,19,10,14,32,142
Raul Neto,PG,24,UTA,40,0,346,41,91,10,31,31,60,8,9,4,26,30,34,21,5,15,48,100
Raymond Felton,PG,32,LAC,80,11,1700,221,514,46,144,175,370,50,64,33,185,218,191,66,22,83,125,538
Reggie Bullock,SF,25,DET,31,5,467,54,128,28,73,26,55,5,7,13,51,64,29,18,3,10,22,141
Reggie Jackson,PG,26,DET,52,50,1424,284,677,66,184,218,493,118,136,21,93,114,270,35,5,114,129,752
Reggie Williams,SF,30,NOP,6,0,79,8,23,5,11,3,12,6,7,2,4,6,4,3,0,0,2,27
Richard Jefferson,SF,36,CLE,79,13,1614,153,343,62,186,91,157,80,108,28,175,203,78,26,10,52,153,448
Richaun Holmes,C,23,PHI,57,17,1193,230,412,27,77,203,335,72,103,94,217,311,58,42,55,55,136,559
Ricky Rubio,PG,26,MIN,75,75,2469,261,650,60,196,201,454,254,285,68,237,305,682,128,10,195,202,836
Robert Covington,SF,26,PHI,67,67,2119,292,732,137,412,155,320,143,174,92,344,436,102,127,69,131,203,864
Robin Lopez,C,28,CHI,81,81,2271,382,775,0,2,382,773,75,104,244,276,520,80,18,117,91,151,839
Rodney Hood,SG,24,UTA,59,55,1593,272,666,114,307,158,359,90,115,16,186,202,96,38,11,65,132,748
Rodney McGruder,SG,25,MIA,78,65,1966,190,460,73,220,117,240,44,71,94,162,256,124,46,18,56,140,497
Rodney Stuckey,PG,30,IND,39,0,696,91,244,19,60,72,184,80,107,6,78,84,84,16,0,53,44,281
Ron Baker,SG,23,NYK,52,13,857,82,217,23,86,59,131,28,43,12,86,98,107,34,8,56,74,215
Rondae Hollis-Jefferson,SF,22,BRK,78,50,1761,235,542,15,67,220,475,190,253,96,356,452,154,82,44,116,177,675
Ronnie Price,PG,33,PHO,14,0,134,4,24,3,17,1,7,3,4,3,8,11,18,11,1,3,14,14
Roy Hibbert,C,30,TOT,48,13,682,80,147,0,0,80,147,61,75,54,98,152,21,8,46,32,100,221
Rudy Gay,SF,30,SAC,30,30,1013,201,442,42,113,159,329,118,138,35,155,190,83,44,26,74,79,562
Rudy Gobert,C,24,UTA,81,81,2744,413,625,0,1,413,624,311,476,314,721,1035,97,49,214,147,246,1137
Russell Westbrook,PG,28,OKC,81,81,2802,824,1941,200,583,624,1358,710,840,137,727,864,840,132,31,438,190,2558
Ryan Anderson,PF,28,HOU,72,72,2116,323,773,204,506,119,267,129,150,112,218,330,68,31,14,55,142,979
Ryan Kelly,PF,25,ATL,16,0,110,8,28,4,10,4,18,5,6,1,17,18,8,4,5,4,5,25
Salah Mejri,C,30,DAL,73,11,905,88,137,1,3,87,134,36,61,97,211,308,14,32,61,40,152,213
Sam Dekker,PF,22,HOU,77,2,1419,203,429,60,187,143,242,38,68,94,190,284,76,38,21,41,83,504
Sasha Vujacic,SG,32,NYK,42,4,408,42,136,23,74,19,62,17,24,12,47,59,52,13,2,16,38,124
Sean Kilpatrick,SG,27,BRK,70,24,1754,305,735,105,308,200,427,204,242,22,258,280,157,45,6,135,118,919
Semaj Christon,PG,24,OKC,64,1,973,77,223,12,63,65,160,17,31,19,68,87,130,28,7,43,79,183
Serge Ibaka,PF,27,TOT,79,79,2422,471,982,124,317,347,665,107,125,129,409,538,75,41,124,105,215,1173
Sergio Rodriguez,PG,30,PHI,68,30,1518,210,536,92,252,118,284,18,27,21,136,157,344,49,4,128,95,530
Seth Curry,PG,26,DAL,70,42,2029,338,703,137,322,201,381,85,100,25,154,179,189,79,7,92,126,898
Shabazz Muhammad,SF,24,MIN,78,1,1516,288,598,49,145,239,453,147,190,84,136,220,35,22,6,56,86,772
Shabazz Napier,PG,25,POR,53,2,512,73,183,34,92,39,91,38,49,8,53,61,67,32,2,41,38,218
Shaun Livingston,PG,31,GSW,76,3,1345,173,316,1,3,172,313,42,60,28,123,151,139,38,20,62,120,389
Shawn Long,C,24,PHI,18,0,234,61,109,7,19,54,90,19,35,41,44,85,13,9,9,13,49,148
Sheldon Mac,SG,24,WAS,30,3,287,30,75,7,30,23,45,23,27,4,30,34,15,8,2,5,17,90
Shelvin Mack,PG,26,UTA,55,9,1205,170,381,37,120,133,261,53,77,20,105,125,154,42,3,90,100,430
Skal Labissiere,PF,20,SAC,33,12,612,117,218,3,8,114,210,52,74,51,111,162,27,16,13,37,64,289
Solomon Hill,SF,25,NOP,80,71,2374,183,478,94,270,89,208,103,128,51,256,307,141,72,32,82,182,563
Spencer Dinwiddie,PG,23,BRK,59,18,1334,134,302,38,101,96,201,126,159,27,137,164,185,44,23,66,119,432
Spencer Hawes,PF,28,TOT,54,1,797,134,277,25,81,109,196,44,52,38,153,191,81,15,30,49,77,337
Stanley Johnson,SF,20,DET,77,1,1371,129,365,45,154,84,211,36,53,36,153,189,105,56,24,71,121,339
Stephen Curry,PG,28,GSW,79,79,2638,675,1443,324,789,351,654,325,362,61,292,353,524,142,17,239,183,1999
Stephen Zimmerman,C,20,ORL,19,0,108,10,31,0,0,10,31,3,5,11,24,35,4,2,5,3,17,23
Steve Novak,PF,33,MIL,8,0,22,2,7,1,6,1,1,0,0,0,3,3,0,0,0,0,1,5
Steven Adams,C,23,OKC,80,80,2389,374,655,0,1,374,654,157,257,281,332,613,86,89,78,146,195,905
T.J. McConnell,PG,24,PHI,81,51,2133,236,512,11,55,225,457,73,90,39,212,251,534,134,10,159,139,556
T.J. Warren,SF,23,PHO,66,59,2048,403,814,26,98,377,716,119,154,125,214,339,75,76,39,57,175,951
Taj Gibson,PF,31,TOT,78,71,1989,365,709,3,13,362,696,113,158,158,327,485,73,41,65,105,163,846
Tarik Black,C,25,LAL,67,16,1091,150,294,1,2,149,292,82,109,144,199,343,39,29,44,58,173,383
Taurean Waller-Prince,SF,22,ATL,59,10,981,114,285,33,102,81,183,74,94,25,132,157,55,43,27,61,96,335
Terrence Jones,PF,25,TOT,54,12,1270,231,492,19,75,212,417,103,170,65,241,306,59,40,54,48,67,584
Terrence Ross,SF,25,TOT,78,24,1955,326,746,142,391,184,355,64,77,18,188,206,88,87,33,68,143,858
Terry Rozier,PG,22,BOS,74,0,1263,151,411,57,179,94,232,51,66,40,187,227,131,46,11,47,69,410
Thabo Sefolosha,SF,32,ATL,62,42,1596,174,395,41,120,133,275,55,75,54,216,270,107,96,31,58,97,444
Thaddeus Young,PF,28,IND,74,74,2237,362,687,45,118,317,569,45,86,131,317,448,122,113,29,95,135,814
Thomas Robinson,PF,25,LAL,48,1,560,105,196,0,1,105,195,31,66,84,139,223,31,26,9,46,76,241
Thon Maker,C,19,MIL,57,34,562,83,181,28,74,55,107,32,49,40,74,114,23,10,26,17,84,226
Tiago Splitter,C,32,PHI,8,0,76,14,31,2,6,12,25,9,11,8,14,22,4,1,1,6,8,39
Tim Frazier,PG,26,NOP,65,35,1525,163,404,40,128,123,276,98,129,34,139,173,335,56,6,101,133,464
Tim Hardaway,SG,24,ATL,79,30,2154,415,912,149,417,266,495,164,214,35,189,224,182,55,15,106,103,1143
Tim Quarterman,SG,22,POR,16,0,80,13,29,5,13,8,16,0,3,4,10,14,11,2,3,11,6,31
Timofey Mozgov,C,30,LAL,54,52,1104,169,328,0,1,169,327,63,78,104,160,264,43,16,31,72,133,401
Timothe Luwawu-Cabarrot,SF,21,PHI,69,19,1190,145,361,50,161,95,200,105,123,25,124,149,75,32,10,73,154,445
Tobias Harris,PF,24,DET,82,48,2567,511,1063,109,314,402,749,190,226,63,353,416,142,60,39,96,133,1321
Tomas Satoransky,SG,25,WAS,57,3,719,61,147,9,37,52,110,23,33,25,58,83,92,26,6,38,60,154
Toney Douglas,PG,30,MEM,24,0,394,43,117,7,42,36,75,24,29,13,48,61,56,18,5,21,50,117
Tony Allen,SG,35,MEM,71,66,1914,274,595,15,54,259,541,80,130,166,225,391,98,115,29,100,178,643
Tony Parker,PG,34,SAS,63,63,1587,265,569,23,69,242,500,85,117,9,104,113,285,34,2,89,92,638
Tony Snell,SG,25,MIL,80,80,2336,246,541,144,355,102,186,47,58,22,226,248,96,55,14,55,125,683
Treveon Graham,SG,23,CHO,27,1,189,19,40,9,15,10,25,10,15,5,17,22,6,6,1,3,18,57
Trevor Ariza,SF,31,HOU,80,80,2773,326,798,191,555,135,243,93,126,54,404,458,175,147,20,73,133,936
Trevor Booker,PF,29,BRK,71,43,1754,305,591,25,78,280,513,74,110,143,428,571,138,75,28,127,152,709
Trey Burke,PG,24,WAS,57,0,703,116,255,31,70,85,185,22,29,7,40,47,100,11,5,48,54,285
Trey Lyles,PF,21,UTA,71,4,1158,159,439,65,204,94,235,57,79,48,187,235,69,26,20,64,97,440
Tristan Thompson,C,25,CLE,78,78,2336,262,437,0,3,262,434,106,213,286,429,715,77,39,84,64,176,630
Troy Daniels,SG,25,MEM,67,3,1183,185,495,138,355,47,140,43,54,22,78,100,46,20,4,45,90,551
Troy Williams,SF,22,TOT,30,16,557,73,167,18,62,55,105,21,32,15,54,69,25,27,10,32,60,185
Ty Lawson,PG,29,SAC,69,24,1732,237,522,34,118,203,404,173,217,44,135,179,334,74,6,129,119,681
Tyler Ennis,PG,22,TOT,53,2,588,90,208,27,70,63,138,21,25,9,36,45,86,25,2,45,58,228
Tyler Johnson,PG,24,MIA,73,0,2178,357,824,93,250,264,574,195,254,50,243,293,233,84,44,90,176,1002
Tyler Ulis,PG,21,PHO,61,15,1123,184,437,21,79,163,358,55,71,20,75,95,226,48,5,77,73,444
Tyler Zeller,C,27,BOS,51,5,525,78,158,0,1,78,157,22,39,43,81,124,42,7,21,20,61,178
Tyreke Evans,SF,27,TOT,40,6,788,150,370,42,118,108,252,69,92,13,124,137,124,35,9,61,60,411
Tyson Chandler,C,34,PHO,47,46,1298,153,228,0,0,153,228,91,124,153,386,539,30,33,24,65,126,397
Tyus Jones,PG,20,MIN,60,0,774,75,181,26,73,49,108,33,43,10,57,67,156,48,5,38,50,209
Udonis Haslem,C,36,MIA,16,0,130,11,23,0,3,11,20,9,15,8,28,36,6,6,1,8,22,31
Victor Oladipo,SG,24,OKC,67,67,2222,412,932,127,352,285,580,116,154,39,252,291,176,78,21,119,155,1067
Vince Carter,SF,40,MEM,73,15,1799,193,490,112,296,81,194,88,115,36,191,227,133,60,36,50,163,586
Wade Baldwin,PG,20,MEM,33,1,405,36,115,3,22,33,93,31,37,11,35,46,61,18,7,39,40,106
Wayne Ellington,SG,29,MIA,62,13,1500,231,555,149,394,82,161,37,43,18,114,132,70,35,4,30,70,648
Wayne Selden,SG,22,TOT,14,5,236,25,58,7,28,18,30,14,22,1,15,16,13,6,1,12,18,71
Wesley Johnson,SF,29,LAC,68,3,810,73,200,29,118,44,82,11,17,26,155,181,23,29,30,18,83,186
Wesley Matthews,SG,30,DAL,73,73,2495,333,847,174,479,159,368,146,179,18,241,259,210,77,15,102,161,986
Will Barton,SG,26,DEN,60,19,1705,295,666,87,235,208,431,143,190,58,201,259,206,48,28,97,110,820
Willie Cauley-Stein,C,23,SAC,75,21,1421,255,481,0,2,255,479,101,151,85,254,339,80,53,44,69,147,611
Willie Reed,C,26,MIA,71,5,1031,162,285,1,4,161,281,49,88,129,203,332,26,18,47,31,137,374
Willy Hernangomez,C,22,NYK,72,22,1324,246,465,4,15,242,450,91,125,170,332,502,96,41,36,100,150,587
Wilson Chandler,SF,29,DEN,71,33,2197,433,939,110,326,323,613,141,194,103,357,460,141,51,30,114,172,1117
Yogi Ferrell,PG,23,TOT,46,29,1197,160,394,68,176,92,218,74,89,20,91,111,172,42,9,70,90,462
Zach LaVine,SG,21,MIN,47,47,1749,326,710,120,310,206,400,117,140,19,141,160,139,41,10,85,104,889
Zach Randolph,PF,35,MEM,73,5,1786,433,964,21,94,412,870,141,193,182,416,598,122,38,10,99,136,1028
Zaza Pachulia,C,32,GSW,70,70,1268,164,307,0,2,164,305,98,126,140,270,410,132,59,33,87,166,426